Placement;Name;Born;Category;Country;Team;City;Gender;Number;Category/Placement;1.day/1.time;1.day/2.time;1.day/3.time;1.day/sum;2.day/1.time;2.day/2.time;2.day/3.time;2.day/sum;3.day/1.time;3.day/2.time;3.day/3.time;3.day/sum;4.day/1.time;4.day/2.time;4.day/3.time;4.day/sum;Result;Ran km;event_year;finished;age;average_tempo(minutes/km)
1.0;Beda Szabolcs;1977;M3;HUN;ELTE SE Sashegyi gepárdok;Budapest;M;484;F3 / 1;3696;3732;3949;11377;3872;3651;5109;12632;3162;4182;3090;10434;3841;4946;3744;12531;46974;196.0;2020;True;43;3.9943877551020406
2.0;Bódis Tamás;1988;M2;HUN;ELTE SE Sashegyi gepárdok;Budapest;M;479;F1 / 1;3690;3738;4261;11689;3870;3654;5698;13222;2957;4060;3085;10102;3701;4817;3729;12247;47260;196.0;2020;True;32;4.0187074829931975
3.0;Theisinger, Wolfgang;1982;M2;GER;RC Abschnitt Mitte;Regenstauf;M;511;F2 / 1;3951;0;8308;12259;4257;4112;5653;14022;3370;4450;3258;11078;4163;5324;3947;13434;50793;196.0;2020;True;38;4.319132653061224
4.0;Strifler Attila;1986;M2;HUN;-;Gyula;M;407;F1 / 2;4140;4131;4430;12701;4406;4218;5740;14364;3367;4453;3324;11144;4180;5326;4052;13558;51767;196.0;2020;True;34;4.401955782312925
5.0;Szedlák Csaba;1978;M3;HUN;Vitalitás SE;Budapest;M;449;F3 / 2;4049;4158;4484;12691;4263;4138;6029;14430;3574;4620;3659;11853;4289;5479;4247;14015;52989;196.0;2020;True;42;4.505867346938776
6.0;Peyer Zoltán;1980;M3;HUN;Oxygen wellness;Budapest;M;476;F2 / 2;4089;4234;4587;12910;4439;4151;5508;14098;3504;4616;3395;11515;4436;5570;4731;14737;53260;196.0;2020;True;40;4.52891156462585
7.0;Schmidt Norbert;1976;M3;HUN;Terepsport Club SE;Mór;M;442;F3 / 3;4380;4517;4629;13526;4601;4356;6000;14957;3606;4768;3569;11943;4525;5711;4183;14419;54845;196.0;2020;True;44;4.663690476190476
8.0;Simonyi Balázs;1980;M3;HUN;Budapesti Honvéd SE;Budapest;M;478;F2 / 3;4044;0;9089;13133;4501;0;10371;14872;3380;4604;3442;11426;4785;6376;4852;16013;55444;196.0;2020;True;40;4.714625850340136
9.0;Drexler Zoltán;1975;M3;HUN;Runberries;Budapest;M;108;F3 / 4;4398;4501;4645;13544;4628;4512;6261;15401;3758;4992;3728;12478;4561;5949;4506;15016;56439;196.0;2020;True;45;4.799234693877551
10.0;Vörös József;1966;M4;HUN;-;Eger;M;292;F4 / 1;4635;4730;4869;14234;4788;4549;6355;15692;3694;5038;3547;12279;4637;6012;4526;15175;57380;196.0;2020;True;54;4.879251700680272
1.0;Butoracova, Ivana;1980;F3;SVK;MTC VYSNA SEBASTOVA;Presov;F;531;N2 / 1;4590;4608;4807;14005;4690;4545;6502;15737;3778;5098;3697;12573;4701;6035;4504;15240;57555;196.0;2020;True;40;4.894132653061225
11.0;Kovac, Tibor;1972;M3;SVK;-;Banska Bystrica;M;226;F3 / 5;4312;4376;4741;13429;4683;0;11022;15705;3795;5079;3883;12757;4870;6176;4783;15829;57720;196.0;2020;True;48;4.908163265306122
12.0;Bognár Ákos dr.;1977;M3;HUN;-;Érd;M;288;F3 / 6;4743;4689;4878;14310;4836;4673;6577;16086;3803;5000;3713;12516;4809;6003;4365;15177;58089;196.0;2020;True;43;4.939540816326531
13.0;Dóbé Zsolt;1974;M3;HUN;-;Szeged;M;112;F3 / 7;4333;4436;5001;13770;4845;4894;7145;16884;3861;5156;3900;12917;4633;5994;4506;15133;58704;196.0;2020;True;46;4.9918367346938775
14.0;Kaluz Ákos Bertalan;1981;M2;HUN;Honvéd Szondi SE;Székesfehérvár;M;404;F2 / 4;4645;4674;4997;14316;4702;4649;6589;15940;3811;5153;3942;12906;4798;6103;4705;15606;58768;196.0;2020;True;39;4.997278911564626
15.0;Bogár János;1964;M4;HUN;Hegyalja2050 SE;Fancsal;M;453;F4 / 2;4109;4891;5601;14601;4581;4734;6683;15998;3501;5043;3842;12386;4649;6476;4775;15900;58885;196.0;2020;True;56;5.007227891156463
16.0;Winckiewicz, Marek;1976;M3;POL;PL Certus / Penta Hospitals;Poznań;M;513;F3 / 8;4722;4731;4912;14365;4937;4827;6497;16261;3894;5167;3781;12842;4891;6286;4584;15761;59229;196.0;2020;True;44;5.036479591836734
17.0;Simon György;1984;M2;HUN;Békéscsabai AC;Békéscsaba;M;311;F2 / 5;4761;4738;4851;14350;4873;4662;7115;16650;3787;5087;3719;12593;4873;6277;4494;15644;59237;196.0;2020;True;36;5.037159863945578
18.0;Halász László;1978;M3;HUN;-;Tatabánya;M;282;F3 / 9;4537;4777;4902;14216;4778;4695;6548;16021;3903;5505;3888;13296;4902;6403;4832;16137;59670;196.0;2020;True;42;5.073979591836735
2.0;Zétényi Szvetlana;1976;F3;HUN;Békéscsabai Atlétikai Club;Békéscsaba;F;474;N2 / 2;4760;4734;4839;14333;4980;0;11347;16327;4059;5417;3775;13251;4963;6370;4508;15841;59752;196.0;2020;True;44;5.080952380952381
19.0;Sánta Norbert;1981;M2;HUN;-;Jászberény;M;272;F2 / 6;4523;4692;5278;14493;4790;4804;6931;16525;3782;0;9367;13149;4906;6031;4726;15663;59830;196.0;2020;True;39;5.087585034013605
20.0;Pálfi János;1977;M3;HUN;-;Riemst;M;269;F3 / 10;4531;4527;5051;14109;4708;4936;7130;16774;3731;5142;4014;12887;4701;6290;5077;16068;59838;196.0;2020;True;43;5.088265306122449
21.0;Papp Zoltán Levente;1981;M2;HUN;Ensport;Budapest;M;258;F2 / 7;4451;4530;5161;14142;4698;4730;6651;16079;3903;5558;4152;13613;5029;6656;4846;16531;60365;196.0;2020;True;39;5.133078231292517
22.0;Vanya Sándor;1964;M4;HUN;-;Szekszárd;M;409;F4 / 3;4712;4725;4883;14320;4935;4828;6727;16490;4003;5418;3924;13345;5131;6420;4792;16343;60498;196.0;2020;True;56;5.1443877551020405
3.0;Schmidt Adrienn;1991;F2;HUN;MUSZE;Mór;F;444;N1 / 1;4828;5080;5418;15326;4817;4775;6698;16290;3880;5258;3957;13095;5033;6164;4616;15813;60524;196.0;2020;True;29;5.1465986394557826
23.0;Bíró Attila;1978;M3;SVK;-;Dunaszerdahely;M;169;F3 / 11;4817;4916;5335;15068;5089;4982;6873;16944;3987;5258;3829;13074;4921;6397;4274;15592;60678;196.0;2020;True;42;5.15969387755102
24.0;Vörös, Róbert;1990;M2;SVK;-;Veľký Meder;M;193;F1 / 3;4821;4914;5331;15066;5096;4982;6861;16939;3991;5253;3836;13080;4906;6397;4293;15596;60681;196.0;2020;True;30;5.159948979591837
25.0;Földesi Zsolt;1982;M2;HUN;Knorr-Bremse;Budapest;M;262;F2 / 8;4668;4696;5817;15181;4824;4968;7504;17296;3962;5293;3938;13193;4719;5808;4502;15029;60699;196.0;2020;True;38;5.161479591836734
4.0;Boldyreva, Oksana;1988;F2;RUS;-;Kazan;F;527;N1 / 2;4643;4851;5137;14631;4850;4913;6724;16487;4074;5631;4079;13784;5074;6454;4619;16147;61049;196.0;2020;True;32;5.191241496598639
26.0;Kovács Ádám;1973;M3;HUN;-;Budapest;M;434;F3 / 12;4521;4598;5135;14254;4946;4955;7204;17105;4007;5349;4098;13454;5051;6614;4941;16606;61419;196.0;2020;True;47;5.222704081632653
27.0;Balogh Róbert;1980;M3;HUN;-;Békéscsaba;M;436;F3 / 13;4974;5078;5012;15064;5022;4831;6700;16553;4048;5403;3988;13439;5112;6669;4929;16710;61766;196.0;2020;True;40;5.252210884353742
28.0;Ferenczi Istvan;1977;M3;HUN;Vasas;Solymár;M;287;F3 / 14;5107;5120;5277;15504;5138;4980;6720;16838;4082;5449;3881;13412;5041;6447;4537;16025;61779;196.0;2020;True;43;5.253316326530613
29.0;Hoskó Roland;1976;M3;HUN;-;Budapest;M;129;F3 / 15;5000;5072;5307;15379;5094;4897;6993;16984;4104;5471;4056;13631;4936;6342;4829;16107;62101;196.0;2020;True;44;5.280697278911565
30.0;Tóth Bálint;1979;M3;HUN;-;Budapest;M;107;F3 / 16;4971;5104;5398;15473;4989;5439;7351;17779;3823;5338;3962;13123;4772;6473;4625;15870;62245;196.0;2020;True;41;5.292942176870748
31.0;Lukács Sándor;1975;M3;HUN;-;Bócsa;M;266;F3 / 17;4797;4904;5157;14858;4976;4890;6914;16780;4107;0;9750;13857;5123;6624;5149;16896;62391;196.0;2020;True;45;5.305357142857142
32.0;Blaskó Mihály;1980;M3;HUN;Monorierdei Szabadidősport;Monorierdő;M;485;F2 / 9;4771;4685;4869;14325;4923;4975;7185;17083;3920;5475;3938;13333;5293;7121;5340;17754;62495;196.0;2020;True;40;5.3142006802721085
33.0;Kormos Attila dr.;1970;M3;HUN;-;Budapest;M;481;F3 / 18;5194;5078;5220;15492;5307;5093;6883;17283;4225;5460;3909;13594;5159;6464;4730;16353;62722;196.0;2020;True;50;5.333503401360543
34.0;Iván Bence;1995;M1;HUN;Knorr-Bremse;Budapest;M;261;F1 / 4;4669;4956;6141;15766;4829;4890;7067;16786;3969;5630;4171;13770;4692;6534;5353;16579;62901;196.0;2020;True;25;5.348724489795918
35.0;Tigyi László;1960;M5;HUN;SZUFLA;Budapest;M;162;F4 / 4;4971;5084;5165;15220;5196;5063;6993;17252;4056;5640;4250;13946;5182;0;11540;16722;63140;196.0;2020;True;60;5.369047619047619
36.0;Lenti József;1978;M3;HUN;Pomázi Futó Bajnokok SE;Budakalász;M;219;F3 / 19;5599;5690;6000;17289;5396;4979;6886;17261;4107;5311;3940;13358;4715;6069;4419;15203;63111;196.0;2020;True;42;5.366581632653061
37.0;Bazsó Tibor;1970;M3;HUN;Vasi Triatlon Se.;Szombathely;M;171;F3 / 20;4734;4958;5148;14840;5139;5114;6868;17121;4269;5850;4086;14205;5264;6870;5098;17232;63398;196.0;2020;True;50;5.390986394557824
5.0;Bazsóné Pulai Ibolya;1974;F3;HUN;-;Szombathely;F;299;N2 / 3;4732;4962;5146;14840;5140;5114;6868;17122;4265;5845;4098;14208;5274;6858;5101;17233;63403;196.0;2020;True;46;5.391411564625851
38.0;Tóth Csaba;1973;M3;HUN;HASE;Üröm;M;464;F3 / 21;4531;4730;5975;15236;5095;5015;7859;17969;4086;5556;4018;13660;5150;6619;5181;16950;63815;196.0;2020;True;47;5.426445578231292
39.0;Vizserálek Gábor dr.;1989;M2;HUN;Plandurance;Budapest;M;132;F1 / 5;5122;5137;5403;15662;5267;5192;7107;17566;4289;0;9796;14085;5118;6483;4964;16565;63878;196.0;2020;True;31;5.431802721088436
40.0;Takács Balázs;1982;M2;HUN;-;Csömör;M;289;F2 / 10;3943;4349;5287;13579;4313;4551;7133;15997;3789;6143;4846;14778;5323;7641;6665;19629;63983;196.0;2020;True;38;5.4407312925170075
41.0;Keresztes Csaba;1979;M3;HUN;SUHANJ!;Budapest;M;293;F3 / 22;5124;5180;5309;15613;5507;5265;6867;17639;4454;5833;4071;14358;5439;6765;4555;16759;64369;196.0;2020;True;41;5.473554421768707
42.0;Kustor Péter;1971;M3;HUN;AWF;Sopron;M;458;F3 / 23;4240;4515;5266;14021;5024;5332;7513;17869;4151;6028;4627;14806;5255;7018;5426;17699;64395;196.0;2020;True;49;5.475765306122449
43.0;Juhász Mihály Dr.;1967;M4;HUN;-;Csongrád;M;243;F4 / 5;4958;5161;5740;15859;5496;0;12073;17569;4388;5728;4209;14325;5244;0;11583;16827;64580;196.0;2020;True;53;5.491496598639455
44.0;Küllős Máté;1974;M3;HUN;-;Göd (Alsógöd);M;176;F3 / 24;4697;4774;5069;14540;5081;5194;7347;17622;4354;6025;4264;14643;5599;7097;5056;17752;64557;196.0;2020;True;46;5.489540816326531
45.0;Mészáros Lajos;1962;M4;HUN;-;Eger;M;152;F4 / 6;4624;4774;5954;15352;4737;4945;7638;17320;3934;5934;4268;14136;5239;7191;5468;17898;64706;196.0;2020;True;58;5.502210884353742
46.0;Hönsch Viktor;1959;M5;HUN;-;Budapest;M;483;F5 / 1;4693;4944;5425;15062;5300;5075;7428;17803;4404;5750;4295;14449;5332;6919;5204;17455;64769;196.0;2020;True;61;5.507568027210884
6.0;Pap-Csákvári Judit;1970;F3;HUN;-;Tiszaújváros;F;120;N2 / 4;5232;5268;5482;15982;5307;5261;7224;17792;4323;5755;4164;14242;5276;6712;4923;16911;64927;196.0;2020;True;50;5.521003401360543
7.0;Kovács Dóra;1970;F3;HUN;Kilométergyűjtők SE;Biatorbágy;F;408;N2 / 5;5205;5103;5371;15679;5277;5083;6878;17238;4232;5764;4349;14345;5361;7060;5338;17759;65021;196.0;2020;True;50;5.5289965986394565
47.0;Balázs Gergely;1985;M2;HUN;HASE;Szolnok;M;460;F1 / 6;4834;5328;6206;16368;5193;5317;7319;17829;4368;5882;4060;14310;5164;6687;4868;16719;65226;196.0;2020;True;35;5.546428571428571
48.0;Csalló Gergő;1981;M2;HUN;-;Veszprém;M;232;F2 / 11;4946;5112;5417;15475;5286;5095;7299;17680;4102;5711;4304;14117;5400;7135;5625;18160;65432;196.0;2020;True;39;5.5639455782312925
49.0;Takács Gábor;1973;M3;HUN;-;Halásztelek;M;240;F3 / 25;5285;5117;5285;15687;5764;5552;7123;18439;4403;5576;4125;14104;5470;6770;4937;17177;65407;196.0;2020;True;47;5.561819727891156
50.0;Boross András;1981;M2;HUN;-;Felsőzsolca;M;110;F2 / 12;5357;5235;5378;15970;5473;5283;7155;17911;4111;5436;4072;13619;5406;6997;5546;17949;65449;196.0;2020;True;39;5.565391156462585
51.0;Nagy Miklós;1968;M4;HUN;Tapolcai Honvéd SE;Sümeg;M;456;F4 / 7;5210;5241;5453;15904;5439;5370;7321;18130;4304;5834;4131;14269;5400;6840;5045;17285;65588;196.0;2020;True;52;5.577210884353742
52.0;Bíró Tamás;1975;M3;HUN;-;Eger;M;165;F3 / 26;5131;5191;5324;15646;5243;5153;7113;17509;4270;5808;4245;14323;5213;7329;5612;18154;65632;196.0;2020;True;45;5.580952380952381
53.0;Elford, Nick;1976;M3;GBR;Robert Elford Fitness;Woking;M;561;F3 / 27;4518;4637;5620;14775;5006;5243;7879;18128;3958;6269;4990;15217;5200;7193;5243;17636;65756;196.0;2020;True;44;5.5914965986394565
54.0;Kiss Sándor;1965;M4;HUN;-;Görcsöny;M;313;F4 / 8;4866;5200;5925;15991;5178;5165;7223;17566;4214;5753;4440;14407;5322;7089;5661;18072;66036;196.0;2020;True;55;5.615306122448979
55.0;Szabó László;1957;M5;HUN;Alföld TE;Mezőberény;M;218;F5 / 2;4849;4931;5823;15603;5516;0;12960;18476;4390;5764;4291;14445;5411;6982;5006;17399;65923;196.0;2020;True;63;5.605697278911565
8.0;Sebestyén Tímea;1978;F3;HUN;Egri Városi Sportiskola;Eger;F;422;N2 / 6;4785;5276;5579;15640;5133;5182;7391;17706;4213;5715;4451;14379;5535;7297;5706;18538;66263;196.0;2020;True;42;5.634608843537415
56.0;Meleg Attila;1977;M3;HUN;Nudlik SE;Budapest;M;450;F3 / 28;5386;5953;5686;17025;5801;5432;6967;18200;4571;5815;3850;14236;5790;6951;4166;16907;66368;196.0;2020;True;43;5.643537414965987
9.0;Balogh Manyi;1979;F3;HUN;-;Marcali;F;482;N2 / 7;5075;5228;5744;16047;5381;5419;7630;18430;4318;5893;4034;14245;5333;6916;5423;17672;66394;196.0;2020;True;41;5.645748299319727
57.0;Gergely Balázs;1977;M3;HUN;-;Kolozsvár;M;307;F3 / 29;5349;5543;5493;16385;5361;5354;7157;17872;4421;5775;4289;14485;5405;7206;5342;17953;66695;196.0;2020;True;43;5.671343537414965
58.0;Bakó Gábor;1968;M4;HUN;Békési DAC;Budakalász;M;195;F4 / 9;4856;5471;5940;16267;5111;5470;8345;18926;4223;5819;4560;14602;5268;6749;5094;17111;66906;196.0;2020;True;52;5.689285714285714
59.0;Kertész Ervin;1970;M3;HUN;Futóbarátok Egyyesület Győr;Ásványráró;M;164;F3 / 30;4714;4928;5236;14878;5912;5424;7270;18606;4633;5998;4353;14984;5886;7292;5564;18742;67210;196.0;2020;True;50;5.7151360544217695
60.0;Bajári Attila;1987;M2;HUN;-;Monor;M;233;F1 / 7;6017;5367;5513;16897;5498;5312;8222;19032;4388;5732;4174;14294;5242;6621;5177;17040;67263;196.0;2020;True;33;5.719642857142857
10.0;Hallgató-Csík Ivett;1979;F3;HUN;-;Budapest;F;429;N2 / 8;5169;5311;5702;16182;5592;5455;7652;18699;4375;5949;4373;14697;5466;7080;5297;17843;67421;196.0;2020;True;41;5.7330782312925175
61.0;Darányi János;1963;M4;HUN;-;Soltvadkert;M;207;F4 / 10;5378;5690;5793;16861;5757;5643;7374;18774;4378;5816;4247;14441;5380;6962;5090;17432;67508;196.0;2020;True;57;5.740476190476191
62.0;Major Balázs;1974;M3;HUN;-;Budapest;M;238;F3 / 31;5391;5469;5797;16657;5655;5504;7511;18670;4666;5926;4299;14891;5576;6930;5073;17579;67797;196.0;2020;True;46;5.765051020408164
11.0;Haffner Kata;1990;F2;HUN;-;Környe;F;223;N1 / 3;5049;5189;6021;16259;5349;5439;7776;18564;4405;0;10335;14740;5332;7304;5643;18279;67842;196.0;2020;True;30;5.768877551020409
63.0;Zubor Imre;1973;M3;HUN;-;Budapest;M;228;F3 / 32;5280;5390;5595;16265;5340;5320;7388;18048;4482;5946;4406;14834;5677;7544;5624;18845;67992;196.0;2020;True;47;5.781632653061225
64.0;Kollár Zoltán;1965;M4;HUN;Knorr-Bremse;Budapest;M;55;F4 / 11;0;11049;5881;16930;5651;5502;7510;18663;4653;5924;4303;14880;5545;7006;5015;17566;68039;196.0;2020;True;55;5.78562925170068
65.0;Lódi Tamás;1978;M3;HUN;-;Budapest;M;250;F3 / 33;5405;5402;5618;16425;5470;5419;7749;18638;4579;6414;4495;15488;5810;6381;5275;17466;68017;196.0;2020;True;42;5.78375850340136
12.0;Katona Éva dr.;1983;F2;HUN;Kancellária SE;Pécs;F;192;N2 / 9;5274;5476;5508;16258;5595;5934;7454;18983;4422;6324;4294;15040;5622;7136;5000;17758;68039;196.0;2020;True;37;5.78562925170068
66.0;Bátor Péter;1999;M1;HUN;Balatonfüredi Atlétikai Club;Várpalota;M;275;F1 / 8;4318;4455;5499;14272;4557;4891;7693;17141;3969;5833;6562;16364;6363;8207;5855;20425;68202;196.0;2020;True;21;5.799489795918368
67.0;Csepregi Ákos;1983;M2;HUN;-;Keszthely;M;158;F2 / 13;5332;5588;5901;16821;5561;5462;7727;18750;4443;6073;4379;14895;5512;7085;5302;17899;68365;196.0;2020;True;37;5.813350340136055
68.0;Klincsek Géza Örs;1977;M3;HUN;-;Budapest;M;237;F3 / 34;5136;5702;6858;17696;5196;5330;7996;18522;4056;5744;4761;14561;5179;7095;5520;17794;68573;196.0;2020;True;43;5.831037414965987
69.0;Pók János;1963;M4;HUN;Axiál Kft.;Gárdony (Agárd);M;33;F4 / 12;5150;5355;5946;16451;5847;0;13408;19255;4471;0;10247;14718;5439;7333;5435;18207;68631;196.0;2020;True;57;5.835969387755101
70.0;Kőrösi Koppány dr.;1971;M3;HUN;Csécsei Team;Budapest;M;161;F3 / 35;4829;5376;6584;16789;5402;5432;7293;18127;4479;6200;4565;15244;5624;7282;5656;18562;68722;196.0;2020;True;49;5.843707482993197
71.0;Burdov, Alexey;1971;M3;RUS;IRC;Moscow;M;522;F3 / 36;5536;5451;5473;16460;5873;5661;7739;19273;4629;6445;4262;15336;5628;7037;5356;18021;69090;196.0;2020;True;49;5.875
72.0;Maistrenko, Mihail;1992;M2;UKR;-;Dnepr;M;525;F1 / 9;4600;4765;5294;14659;5080;5332;7677;18089;4479;6440;4744;15663;5724;8609;6398;20731;69142;196.0;2020;True;28;5.879421768707482
73.0;Czingráber László;1966;M4;HUN;-;Vác;M;273;F4 / 13;0;10306;5874;16180;5492;5539;8013;19044;4463;6470;4727;15660;5425;7139;5821;18385;69269;196.0;2020;True;54;5.890221088435374
74.0;Venczel Márton;1990;M2;HUN;-;Fót;M;186;F1 / 10;5226;5431;6089;16746;5562;5207;7826;18595;4638;6275;4824;15737;5649;7125;5475;18249;69327;196.0;2020;True;30;5.89515306122449
13.0;Venczel Réka;1990;F2;HUN;-;Budapest;F;187;N1 / 4;5232;5427;6088;16747;5565;5206;7827;18598;4635;6276;4831;15742;5654;7124;5475;18253;69340;196.0;2020;True;30;5.896258503401361
14.0;Balázsiné Boros Linda Anna;1979;F3;HUN;-;Érd;F;277;N2 / 10;5186;5410;5878;16474;5578;5600;7657;18835;4479;6288;4617;15384;5540;7430;5643;18613;69306;196.0;2020;True;41;5.893367346938775
75.0;Bödő Imre;1980;M3;HUN;Honvéd Szondi György SE;Kőszeg;M;461;F2 / 14;5046;5522;5969;16537;5551;5715;7712;18978;4501;6282;4561;15344;5669;7536;5442;18647;69506;196.0;2020;True;40;5.910374149659864
76.0;Donkó Antal;1963;M4;HUN;-;Szolnok;M;168;F4 / 14;5542;5622;5963;17127;5700;5830;7763;19293;4506;6149;4233;14888;5523;7133;5447;18103;69411;196.0;2020;True;57;5.902295918367346
77.0;Papp László;1963;M4;HUN;Tapolcai Honvéd SE;Budapest;M;472;F4 / 15;5464;5475;5537;16476;5704;5653;7838;19195;4687;6376;4462;15525;5653;7114;5519;18286;69482;196.0;2020;True;57;5.908333333333333
78.0;Gellynck, Kris;1979;M3;BEL;FURALOPERS;Bruxelles;M;501;F3 / 37;5161;0;10664;15825;5485;0;12455;17940;4820;0;11197;16017;5910;7951;6279;20140;69922;196.0;2020;True;41;5.945748299319727
79.0;Szabó Norbert;1977;M3;HUN;-;Leányfalu;M;244;F3 / 38;5381;5600;6156;17137;5612;5486;7528;18626;4552;6303;4446;15301;5890;7757;5250;18897;69961;196.0;2020;True;43;5.94906462585034
80.0;Szekeres Tibor;1966;M4;HUN;Kadarka Futóegyesület;Szekszárd;M;157;F4 / 16;5139;5443;6408;16990;5882;5784;8047;19713;4367;5912;4764;15043;5611;7428;5537;18576;70322;196.0;2020;True;54;5.979761904761904
81.0;Schmidt András;1979;M3;HUN;-;Budaörs;M;290;F3 / 39;4852;5217;6304;16373;5580;5711;7769;19060;4543;6503;4547;15593;5890;8063;5466;19419;70445;196.0;2020;True;41;5.990221088435374
82.0;Szalkai Zsolt;1984;M2;HUN;Tapolca Honvéd SE;Tapolca;M;466;F2 / 15;5288;5454;5976;16718;5425;5366;7977;18768;4518;6154;4516;15188;6088;7771;5879;19738;70412;196.0;2020;True;36;5.987414965986394
83.0;Salamon István;1962;M4;HUN;-;Mezőtárkány;M;34;F4 / 17;5311;5434;6540;17285;5671;5728;8445;19844;4461;6253;4406;15120;5436;7356;5602;18394;70643;196.0;2020;True;58;6.007057823129252
15.0;Fehérvári Kata;1982;F2;HUN;Runberries;Budapest;F;239;N2 / 11;5441;5592;5757;16790;5478;5586;7775;18839;4676;6275;4791;15742;5825;7702;5787;19314;70685;196.0;2020;True;38;6.01062925170068
84.0;Pető András ifj;1976;M3;HUN;-;Hatvan;M;454;F3 / 40;5139;5211;6019;16369;5739;5778;8252;19769;4467;6459;4888;15814;5904;7606;5377;18887;70839;196.0;2020;True;44;6.023724489795919
85.0;Dovala, Adrian;1975;M3;SVK;Drnava;Drnava;M;512;F3 / 41;4957;5106;5520;15583;5643;5798;8495;19936;4604;6143;4541;15288;6072;7884;6035;19991;70798;196.0;2020;True;45;6.020238095238096
86.0;Sebestyén Ádám Dr.;1973;M3;HUN;-;Budapest;M;160;F3 / 42;5175;5389;5990;16554;0;11725;8542;20267;4718;6295;4564;15577;5899;0;12494;18393;70791;196.0;2020;True;47;6.019642857142856
87.0;Deák József;1967;M4;HUN;Tapolcai Honvéd SE;Tapolca;M;468;F4 / 18;5213;5433;5380;16026;4982;5295;8676;18953;4778;6487;4411;15676;5748;7765;6693;20206;70861;196.0;2020;True;53;6.025595238095238
88.0;Rudolf József dr.;1970;M3;HUN;-;Budapest;M;134;F3 / 43;5397;5587;5813;16797;5749;6296;7796;19841;4656;6398;4568;15622;5681;7564;5348;18593;70853;196.0;2020;True;50;6.024914965986395
16.0;Witzel, Ricarda;1963;F4;GER;Swiss Mystery Racing Team;Solothurn;F;504;N3 / 1;5307;5504;5850;16661;5772;5758;7871;19401;4581;6312;4608;15501;6087;7687;5570;19344;70907;196.0;2020;True;57;6.029506802721088
89.0;Witzel, Jens;1967;M4;GER;Swiss Mystery Racing Team;Solothurn;M;503;F4 / 19;5307;5520;5834;16661;5772;5759;7870;19401;4582;6313;4605;15500;6094;7668;5590;19352;70914;196.0;2020;True;53;6.030102040816327
90.0;Balogh Roland;1984;M2;HUN;-;Göd;M;142;F2 / 16;5108;5479;6434;17021;5697;5803;8147;19647;4640;6407;4693;15740;5582;7437;5709;18728;71136;196.0;2020;True;36;6.048979591836734
91.0;Lévai Péter;1967;M4;HUN;-;Maklár;M;175;F4 / 20;5143;5408;6125;16676;5772;5974;8339;20085;4454;6297;4742;15493;5565;0;13306;18871;71125;196.0;2020;True;53;6.0480442176870755
92.0;Vanyó László;1977;M3;HUN;-;Gödöllő;M;214;F3 / 44;5148;5344;5972;16464;5501;5710;7912;19123;4499;6557;4842;15898;5836;8032;5835;19703;71188;196.0;2020;True;43;6.053401360544218
93.0;Andó Zsombor;1981;M2;HUN;Legrand SE;Csongrád;M;154;F2 / 17;5143;5318;5694;16155;5630;5605;7981;19216;4589;6637;4810;16036;5766;8123;6081;19970;71377;196.0;2020;True;39;6.069472789115646
94.0;Iliadis, Nikolai;1976;M3;GRE;-;Vienna;M;533;F3 / 45;0;0;17198;17198;6024;6101;8099;20224;4595;6273;4447;15315;5724;7502;5460;18686;71423;196.0;2020;True;44;6.073384353741497
95.0;Udvardi Tibor;1977;M3;HUN;-;Kgs. Lyngby;M;297;F3 / 46;5775;5747;5887;17409;5867;5635;8016;19518;4811;6366;4724;15901;5761;7275;5715;18751;71579;196.0;2020;True;43;6.086649659863945
96.0;Hajdu Péter;1954;M5;HUN;Runberries;Budapest;M;423;F5 / 3;5564;5454;5773;16791;5768;5694;8193;19655;4387;6362;4736;15485;5865;7972;5831;19668;71599;196.0;2020;True;66;6.088350340136054
97.0;Sümegi Elemér;1973;M3;HUN;-;Lókút;M;308;F3 / 47;0;11081;6188;17269;5747;5654;8061;19462;4801;6509;4769;16079;5791;7585;5620;18996;71806;196.0;2020;True;47;6.105952380952381
17.0;Pap Viktória dr.;1972;F3;HUN;Plandurance;Tatabánya;F;143;N2 / 12;5608;5701;5859;17168;5840;5612;7836;19288;4798;6514;4905;16217;5905;7603;5766;19274;71947;196.0;2020;True;48;6.117942176870748
98.0;Márkus György;1983;M2;HUN;MVM SE;Győr;M;265;F2 / 18;5129;5336;5744;16209;5935;6067;8370;20372;4813;6478;4679;15970;6012;8048;5556;19616;72167;196.0;2020;True;37;6.136649659863945
99.0;Krausz István;1952;M5;HUN;Esztergomi Futóművek;Dunaújváros;M;230;F5 / 4;5578;5823;6081;17482;5836;5856;8157;19849;4741;6523;4486;15750;5854;7520;5560;18934;72015;196.0;2020;True;68;6.123724489795919
100.0;Czaltig Zsolt;1974;M3;HUN;-;Lajoskomárom;M;139;F3 / 48;5817;5895;5905;17617;5996;6004;7843;19843;4774;6250;4413;15437;5982;7777;5345;19104;72001;196.0;2020;True;46;6.122534013605442
101.0;Vasas Levente;1981;M2;HUN;-;Kecskemét;M;435;F2 / 19;5397;5282;5905;16584;5657;5741;7657;19055;4505;6696;5376;16577;5672;8424;6062;20158;72374;196.0;2020;True;39;6.154251700680272
102.0;Borsos József;1970;M3;HUN;Dorogi futókör;Csolnok;M;211;F3 / 49;5104;5467;6081;16652;5585;5653;8306;19544;4795;6615;4904;16314;5971;7881;5877;19729;72239;196.0;2020;True;50;6.142772108843538
103.0;Deli Tamás;1976;M3;HUN;-;Leányfalu;M;242;F3 / 50;5377;0;11136;16513;5588;5489;7567;18644;4732;6744;4761;16237;6170;8827;5895;20892;72286;196.0;2020;True;44;6.146768707482993
18.0;Trajbár Judit;1975;F3;HUN;-;Zalaegerszeg;F;147;N2 / 13;5515;5667;5869;17051;5884;5714;8122;19720;4732;6505;4685;15922;5930;7911;6023;19864;72557;196.0;2020;True;45;6.169812925170068
104.0;Gelencsér Zoltán Tibor;1965;M4;HUN;Tapolcai Honvéd SE;Keszthely;M;471;F4 / 21;6021;6016;6299;18336;5800;5748;8981;20529;4276;5951;4676;14903;5503;7345;6033;18881;72649;196.0;2020;True;55;6.177636054421768
105.0;Karhapaa, Marko;1970;M3;FIN;vesisamoilijat;Karjaa;M;507;F3 / 51;5352;5649;6862;17863;6175;6095;8472;20742;4863;6560;4572;15995;5834;7349;5138;18321;72921;196.0;2020;True;50;6.200765306122449
106.0;Simon Zoltán;1970;M3;HUN;-;Solymár;M;37;F3 / 52;5953;6004;6470;18427;6150;5972;7769;19891;4902;6307;4360;15569;6012;7628;5362;19002;72889;196.0;2020;True;50;6.198044217687075
19.0;Udvari-Toth Judit;1987;F2;HUN;-;Bugyi;F;281;N1 / 5;5629;5641;5972;17242;5861;5751;8233;19845;4938;6473;4695;16106;6099;7764;5985;19848;73041;196.0;2020;True;33;6.210969387755101
107.0;Gyepes, Daniel;1978;M3;SVK;-;Dolné Obdokovce;M;234;F3 / 53;5061;5273;5803;16137;5576;5579;7997;19152;4737;6916;5009;16662;6259;8351;6510;21120;73071;196.0;2020;True;42;6.213520408163265
108.0;Szabó Bence;1992;M2;HUN;-;Pápa;M;278;F1 / 11;5756;0;11551;17307;6084;0;13589;19673;4829;6349;4542;15720;6178;8201;6201;20580;73280;196.0;2020;True;28;6.2312925170068025
109.0;Gelányi Attila;1978;M3;HUN;Szászvári Mocorgók Szabadidő Egyesület;Szászvár;M;431;F3 / 54;5939;6030;6450;18419;6222;5971;7980;20173;4883;6878;4713;16474;5582;7227;5267;18076;73142;196.0;2020;True;42;6.219557823129252
110.0;Horváth Krisztián;1974;M3;HUN;-;Celldömölk;M;153;F3 / 55;5551;5848;6287;17686;5905;6228;7875;20008;4819;6687;4870;16376;5953;7909;5657;19519;73589;196.0;2020;True;46;6.257568027210884
111.0;Simon András;1964;M4;HUN;Veresi Futókör;Veresegyház;M;205;F4 / 22;5617;5818;6200;17635;5737;6004;8204;19945;4750;6881;4963;16594;5739;7853;5937;19529;73703;196.0;2020;True;56;6.267261904761905
111.0;Majoross Olivér;1971;M3;HUN;-;Törökbálint;M;146;F3 / 56;5763;5947;6514;18224;6090;6393;8618;21101;4878;6716;4847;16441;5708;7178;5051;17937;73703;196.0;2020;True;49;6.267261904761905
113.0;Forgács Béla;1967;M4;HUN;-;Vácegres;M;428;F4 / 23;5620;5812;6203;17635;5743;5937;8271;19951;4754;6874;4970;16598;5748;7847;5943;19538;73722;196.0;2020;True;53;6.268877551020409
20.0;Stutzke, Silke;1968;F3;GER;LG Nord Berlin Ultrateam;Wandlitz;F;517;N3 / 2;5839;5953;6354;18146;5862;5961;8228;20051;4873;6749;4789;16411;5861;7779;5630;19270;73878;196.0;2020;True;52;6.282142857142857
114.0;Major Tibor dr.;1960;M5;HUN;-;Budapest;M;172;F4 / 24;5625;5683;6195;17503;5805;5894;8622;20321;4715;6540;4952;16207;5832;7868;6294;19994;74025;196.0;2020;True;60;6.294642857142857
115.0;Bene Krisztián dr.;1984;M2;HUN;Tűzoltóság;Budapest;M;437;F2 / 20;5850;5740;6038;17628;6044;5733;8510;20287;4989;6922;5098;17009;6164;7660;5357;19181;74105;196.0;2020;True;36;6.301445578231292
116.0;Tóth Ferenc;1972;M3;HUN;Futaújváros;Dunaújváros;M;140;F3 / 57;5627;5995;6132;17754;6183;6183;8261;20627;4915;6611;4615;16141;6008;7846;5684;19538;74060;196.0;2020;True;48;6.2976190476190474
117.0;Láng István;1957;M5;HUN;Gödi Futóklub;Göd (Alsógöd);M;30;F5 / 5;5466;0;11771;17237;5931;5894;8177;20002;4908;6758;4900;16566;6078;8303;5994;20375;74180;196.0;2020;True;63;6.3078231292517
21.0;Harmati Zsanna;1976;F3;HUN;-;Dunakeszi;F;424;N2 / 14;5647;5839;6207;17693;5832;5729;8243;19804;4819;6915;4811;16545;6163;7997;5933;20093;74135;196.0;2020;True;44;6.303996598639455
22.0;Juhász Zita;1968;F3;HUN;-;Dunakeszi;F;166;N3 / 3;5646;5837;6207;17690;5826;5736;8259;19821;4820;6907;4806;16533;6163;8005;5927;20095;74139;196.0;2020;True;52;6.304336734693878
23.0;Szepessy Edit Dr.;1974;F3;HUN;-;Budapest;F;204;N2 / 15;5805;5813;5946;17564;5980;5907;8706;20593;4871;6683;4789;16343;6028;7904;6106;20038;74538;196.0;2020;True;46;6.338265306122449
118.0;Szocsevka Gábor;1984;M2;HUN;Honvéd Ezüstnyíl SE;Csót;M;477;F2 / 21;5041;5486;6349;16876;5439;5973;8455;19867;4925;7021;5117;17063;6150;8429;6227;20806;74612;196.0;2020;True;36;6.344557823129252
119.0;Sutyinszky Tamás;1972;M3;HUN;-;Budapest;M;256;F3 / 58;5595;5691;6004;17290;5686;5724;8549;19959;4807;6881;5076;16764;6002;8409;6332;20743;74756;196.0;2020;True;48;6.356802721088435
120.0;Zsarkó-Berta László;1979;M3;HUN;-;Budapest;M;255;F3 / 59;4826;5294;6770;16890;5981;6543;8669;21193;4643;7249;5071;16963;5542;7898;6551;19991;75037;196.0;2020;True;41;6.380697278911564
121.0;Lajszner Lajos;1966;M4;HUN;Egri triatlon klub;Eger;M;173;F4 / 25;5531;5775;6157;17463;5959;5991;8512;20462;4764;6590;4629;15983;6184;8682;6329;21195;75103;196.0;2020;True;54;6.3863095238095235
122.0;Farkas László;1967;M4;HUN;-;Budapest;M;20;F4 / 26;5952;6009;6457;18418;6147;5968;8579;20694;4891;6509;4877;16277;5997;7883;5770;19650;75039;196.0;2020;True;53;6.380867346938776
123.0;Szikszai Ferenc ifj;1979;M3;HUN;-;Budapest;M;128;F3 / 60;5036;5276;6325;16637;5517;5649;8701;19867;4764;7466;5572;17802;6141;8235;6618;20994;75300;196.0;2020;True;41;6.403061224489796
124.0;Lojkó Zoltán;1970;M3;HUN;-;Budakeszi;M;216;F3 / 61;6138;6369;6382;18889;6398;6339;7992;20729;5014;6614;4456;16084;6223;7865;5438;19526;75228;196.0;2020;True;50;6.396938775510204
125.0;Bakó Attila;1971;M3;HUN;Győri FutOltók;Kunsziget;M;480;F3 / 62;5134;6412;8311;19857;5757;5681;8450;19888;4484;6412;4965;15861;5597;8388;5848;19833;75439;196.0;2020;True;49;6.414880952380952
126.0;Taksonyi Szilárd;1971;M3;HUN;-;Szekszárd;M;425;F3 / 63;5854;5912;5954;17720;6062;5986;8527;20575;4909;0;11496;16405;6110;8477;6181;20768;75468;196.0;2020;True;49;6.41734693877551
24.0;Szöllősi Anita;1971;F3;HUN;-;Budapest;F;197;N2 / 16;5889;5880;6167;17936;6019;5824;8285;20128;4989;6848;4970;16807;6383;8155;6177;20715;75586;196.0;2020;True;49;6.427380952380952
127.0;Myllyla, Pekka;1969;M4;FIN;-;Tallinn;M;534;F4 / 27;6113;6152;6556;18821;6260;6025;8691;20976;5129;6879;4899;16907;6052;7795;5110;18957;75661;196.0;2020;True;51;6.433758503401361
128.0;Keresztesi Tamás;1983;M2;HUN;Ironteam SE;Rácalmás;M;235;F2 / 22;5942;5948;6299;18189;5994;6117;8274;20385;4876;6728;4828;16432;6161;8417;6318;20896;75902;196.0;2020;True;37;6.454251700680272
25.0;Fejér Zsuzsa;1971;F3;HUN;-;Budapest;F;151;N2 / 17;5898;5846;6169;17913;5818;5817;8630;20265;4998;6824;5087;16909;6315;8398;6286;20999;76086;196.0;2020;True;49;6.469897959183673
26.0;Szabó Istvánné;1969;F3;HUN;-;Budapest;F;155;N3 / 4;6399;7197;6971;20567;6069;5991;7963;20023;4777;6453;4585;15815;5998;8236;5523;19757;76162;196.0;2020;True;51;6.476360544217687
129.0;Károlyi János;1963;M4;HUN;-;Mezőberény;M;443;F4 / 28;5475;5528;6135;17138;5556;7540;8817;21913;4653;7037;5036;16726;5857;8606;6104;20567;76344;196.0;2020;True;57;6.491836734693878
130.0;Aebi, Shawn;1962;M4;USA;-;Woodinville;M;530;F4 / 29;5547;5846;6449;17842;5897;6101;8814;20812;4861;6622;4986;16469;6161;8529;6556;21246;76369;196.0;2020;True;58;6.493962585034013
131.0;Magyar Norbert;1976;M3;HUN;-;Budapest;M;264;F3 / 64;0;10393;6023;16416;5643;5725;8568;19936;4891;7082;5283;17256;6257;9122;7526;22905;76513;196.0;2020;True;44;6.506207482993197
132.0;Pozderka Attila;1978;M3;HUN;HASE;Budapest;M;113;F3 / 65;5789;5661;6484;17934;6130;6310;9367;21807;5316;6919;4926;17161;6266;7943;5550;19759;76661;196.0;2020;True;42;6.518792517006803
27.0;Máté Mónika;1979;F3;HUN;UFÓ SE;Ócsa;F;259;N2 / 18;5801;6208;6412;18421;6226;6022;8755;21003;5088;6948;4997;17033;5746;8609;5847;20202;76659;196.0;2020;True;41;6.518622448979592
133.0;Kurpé László dr.;1970;M3;HUN;-;Hatvan;M;131;F3 / 66;5138;5308;8145;18591;5682;6121;8234;20037;5159;7996;5358;18513;5892;8323;5459;19674;76815;196.0;2020;True;50;6.531887755102041
134.0;Héritier, Vincent;1972;M3;FRA;-;Budapest;M;417;F3 / 67;6037;6171;6310;18518;6279;6283;8409;20971;5214;6979;4931;17124;6368;8206;5903;20477;77090;196.0;2020;True;48;6.555272108843537
28.0;Szeibert-Virág Dóra;1987;F2;HUN;Ócsa SE;Örkény;F;304;N1 / 6;5801;6170;6643;18614;6460;6587;8700;21747;5404;7113;4816;17333;6161;7883;5502;19546;77240;196.0;2020;True;33;6.568027210884353
135.0;Szilágyi Ákos;1980;M3;HUN;-;Budapest;M;106;F2 / 23;5554;5811;6543;17908;6046;5973;9294;21313;4812;6575;4889;16276;6268;8630;6994;21892;77389;196.0;2020;True;40;6.580697278911565
29.0;Hugyecz Attiláné;1970;F3;HUN;-;Kosd;F;427;N2 / 19;5721;5993;6611;18325;5891;0;15083;20974;4936;7100;5244;17280;6103;8516;6261;20880;77459;196.0;2020;True;50;6.586649659863945
136.0;Hegedűs Zoltán;1978;M3;HUN;KEFE- Komárom;Budapest;M;194;F3 / 68;6203;6417;6168;18788;6537;6639;7856;21032;5344;7398;4320;17062;6534;8971;5198;20703;77585;196.0;2020;True;42;6.5973639455782305
137.0;Veres, Sandor;1962;M4;GER;AYCM Racing Team;Chemnitz;M;283;F4 / 30;5740;5814;7240;18794;6400;6419;8614;21433;5299;7138;4822;17259;6348;8210;5730;20288;77774;196.0;2020;True;58;6.61343537414966
138.0;Véső Tamás;1982;M2;HUN;LV Deggendorf;Plattling;M;302;F2 / 24;5803;6112;6882;18797;6067;6298;8564;20929;5133;7256;5211;17600;6226;8173;6082;20481;77807;196.0;2020;True;38;6.616241496598639
30.0;Nagy Izabella dr.;1984;F2;HUN;-;Budapest;F;249;N2 / 20;6090;6172;6721;18983;6297;6251;8888;21436;5280;7097;5036;17413;6331;8016;5719;20066;77898;196.0;2020;True;36;6.623979591836735
139.0;Rogy, Maximilian;1962;M4;AUT;-;Griffen;M;519;F4 / 31;5862;5921;6395;18178;6332;6193;8713;21238;5374;6956;5336;17666;6518;8317;6142;20977;78059;196.0;2020;True;58;6.637670068027211
140.0;Katona György;1970;M3;HUN;-;Budapest;M;184;F4 / 32;5631;5715;6187;17533;5965;6145;8346;20456;4932;7163;5490;17585;6247;9175;7149;22571;78145;196.0;2020;True;50;6.64498299319728
141.0;Szabó Béla;1963;M4;HUN;-;Alsópáhok;M;252;F4 / 33;5737;5683;6541;17961;6423;6175;8874;21472;5152;7231;5291;17674;6277;8285;6648;21210;78317;196.0;2020;True;57;6.659608843537415
142.0;Hugyecz Attila;1969;M4;HUN;Gödi Futóklub;Kosd;M;426;F4 / 34;5680;5858;6789;18327;6265;6724;9179;22168;4920;6973;5013;16906;6110;8754;6241;21105;78506;196.0;2020;True;51;6.675680272108844
31.0;Bíró Henrietta;1975;F3;HUN;-;Göd (Felsőgöd);F;441;N2 / 21;5627;5775;6141;17543;6130;5908;7909;19947;4912;7245;5509;17666;6529;10034;6973;23536;78692;196.0;2020;True;45;6.691496598639455
143.0;Schilt László ifj;1994;M1;HUN;-;Kaposvár-Toponár;M;279;F1 / 12;5401;5300;6924;17625;5978;6347;9539;21864;4787;6871;5294;16952;6515;8692;7094;22301;78742;196.0;2020;True;26;6.695748299319727
144.0;Kalmár Péter;1972;M3;HUN;-;Budaörs;M;448;F3 / 69;5761;5903;6732;18396;6006;6180;9386;21572;4856;6968;5428;17252;5969;9083;6561;21613;78833;196.0;2020;True;48;6.703486394557824
145.0;Béry Norbert;1970;M3;HUN;Kőszegi Triatlon és Úszó Klub;Söpte;M;127;F3 / 70;5762;6062;6815;18639;5698;6202;9129;21029;4810;7421;5282;17513;6023;8803;6904;21730;78911;196.0;2020;True;50;6.710119047619048
146.0;Kis Tamás;1991;M2;HUN;-;Érd;M;220;F1 / 13;6194;6134;6615;18943;6435;6198;8936;21569;5119;6762;5215;17096;6403;8528;6432;21363;78971;196.0;2020;True;29;6.715221088435374
32.0;Jung Márta;1969;F3;HUN;-;Hőgyész;F;167;N3 / 5;5519;5757;6409;17685;6014;6222;8836;21072;4919;0;12643;17562;6484;9031;7095;22610;78929;196.0;2020;True;51;6.711649659863945
147.0;Zömbik László;1961;M4;HUN;Tapolcai Honvéd SE;Keszthely;M;465;F4 / 35;5970;6188;6475;18633;6057;6097;8595;20749;5109;7643;5983;18735;6044;8541;6539;21124;79241;196.0;2020;True;59;6.738180272108844
148.0;Sipos Sándor;1957;M5;HUN;HASE;Budapest;M;405;F5 / 6;6161;6260;6541;18962;6260;6351;8941;21552;5138;7060;5135;17333;6566;8392;6502;21460;79307;196.0;2020;True;63;6.743792517006803
149.0;Berger Tamás;1980;M3;HUN;Honvéd Szondi SE;Székesfehérvár;M;462;F2 / 25;6159;6455;6904;19518;6471;6395;8583;21449;5312;7154;5150;17616;6370;7973;6503;20846;79429;196.0;2020;True;40;6.754166666666666
33.0;Némethné Killer Zsanett;1977;F3;HUN;-;Nagylóc;F;122;N2 / 22;5613;6368;7448;19429;6086;7032;9022;22140;4721;7390;5259;17370;6100;8323;6219;20642;79581;196.0;2020;True;43;6.767091836734694
150.0;Határ Máté;1983;M2;HUN;-;Nagylóc;M;121;F2 / 26;5617;6378;7431;19426;6084;7030;9033;22147;4725;7385;5262;17372;6094;8316;6224;20634;79579;196.0;2020;True;37;6.7669217687074825
151.0;Szőke Zoltán;1972;M3;HUN;-;Tiszavasvári;M;231;F3 / 71;6240;6383;6817;19440;6357;6444;8843;21644;5255;7200;5190;17645;6220;8422;6414;21056;79785;196.0;2020;True;48;6.784438775510204
152.0;Bondarenko, Oleksii;1973;M3;UKR;REDHEAD;Dnipro;M;536;F3 / 72;6097;6045;6322;18464;6161;6136;8684;20981;5207;7359;5799;18365;6248;8446;7314;22008;79818;196.0;2020;True;47;6.787244897959184
34.0;Ormos Zsuzsanna;1975;F3;HUN;Futóbarátok Egyesület;Győr;F;130;N2 / 23;5635;6037;6627;18299;6156;6313;8905;21374;4911;7380;5515;17806;6256;8855;7359;22470;79949;196.0;2020;True;45;6.798384353741497
153.0;Szabó Balázs dr.;1970;M3;HUN;Iron Team;Budapest;M;133;F3 / 73;5894;6102;6805;18801;6715;6718;9217;22650;5246;7197;5134;17577;6452;8243;6240;20935;79963;196.0;2020;True;50;6.799574829931973
154.0;Prekopp Péter Dr.;1978;M3;HUN;AVSE;Budapest;M;516;F3 / 74;5896;6097;6808;18801;6722;6717;9216;22655;5245;7201;5136;17582;6443;0;14489;20932;79970;196.0;2020;True;42;6.80017006802721
35.0;Schneller Erika;1968;F3;HUN;-;Szentendre;F;103;N3 / 6;5939;6216;6471;18626;6237;6344;8656;21237;5159;7413;5253;17825;6395;9411;6661;22467;80155;196.0;2020;True;52;6.815901360544218
36.0;Kelemen Anett;1987;F2;HUN;-;Pilisvörösvár;F;185;N1 / 7;6424;6333;6870;19627;6457;6382;9273;22112;5104;7140;5260;17504;6346;8251;6375;20972;80215;196.0;2020;True;33;6.821003401360545
155.0;Pálfi László ifj;1977;M3;HUN;Hegyalja2050 SE;Kazincbarcika;M;247;F3 / 75;5938;6461;7340;19739;6307;6298;9088;21693;5050;7603;4756;17409;6382;8954;6079;21415;80256;196.0;2020;True;43;6.824489795918367
156.0;Kormos Attila;1984;M2;HUN;-;Budapest;M;196;F2 / 27;6324;6380;6966;19670;6644;6465;9015;22124;5337;6969;5341;17647;6317;8369;6161;20847;80288;196.0;2020;True;36;6.827210884353742
157.0;Hiegel, Daniel;1964;M4;FRA;Cgfm;Habsheim;M;514;F4 / 36;5576;5945;7233;18754;5946;7452;9961;23359;4813;6971;5187;16971;6219;9038;6124;21381;80465;196.0;2020;True;56;6.842261904761904
158.0;Engel, Karsten;1968;M4;GER;Die Antiken spielen;Berlin;M;528;F4 / 37;5922;5785;6376;18083;6043;6126;8853;21022;4995;8313;5720;19028;6326;8877;7064;22267;80400;196.0;2020;True;52;6.836734693877551
159.0;Tanyik Jozsef;1980;M3;HUN;-;Budapest;M;170;F2 / 28;5989;6094;6411;18494;6589;6437;9256;22282;5337;7218;5316;17871;6698;8785;6561;22044;80691;196.0;2020;True;40;6.861479591836734
160.0;Tóth Ferenc;1970;M3;HUN;-;Kazincbarcika;M;309;F3 / 76;5780;6114;7412;19306;6234;6475;9403;22112;5177;7106;5133;17416;6173;8866;6829;21868;80702;196.0;2020;True;50;6.862414965986394
37.0;Viniczai Andrea;1976;F3;HUN;SUHANJ!;Budapest;F;181;N2 / 24;6205;6410;6446;19061;6545;6625;8723;21893;5339;7389;5011;17739;6559;9774;5759;22092;80785;196.0;2020;True;44;6.869472789115647
38.0;Bodnar Agnes;1987;F2;HUN;-;Szolnok;F;115;N1 / 8;5917;6627;6539;19083;6221;7101;9586;22908;4860;7232;5497;17589;6210;8439;6650;21299;80879;196.0;2020;True;33;6.877465986394558
161.0;Kadenszky Zsolt;1972;M3;HUN;Péceli Párducok;Pécel;M;111;F3 / 77;6085;6489;7014;19588;6621;6796;9079;22496;5052;7018;5308;17378;6243;8516;6620;21379;80841;196.0;2020;True;48;6.8742346938775505
162.0;Kreszta Zoltán;1970;M3;HUN;-;Budapest;M;11;F3 / 78;4854;5135;7191;17180;6756;6453;9248;22457;5223;7428;6100;18751;6524;8640;7466;22630;81018;196.0;2020;True;50;6.889285714285714
163.0;Rácz László;1977;M3;HUN;Lacko Box SE;Tárnok;M;267;F3 / 79;5842;6046;7153;19041;6284;6658;9633;22575;5234;7322;5477;18033;6273;8834;6420;21527;81176;196.0;2020;True;43;6.902721088435374
164.0;Kóder Gábor;1981;M2;HUN;Újpalota SC;Dunakeszi;M;177;F2 / 29;5786;6215;7129;19130;6451;6694;8643;21788;0;13687;5285;18972;6417;8193;6793;21403;81293;196.0;2020;True;39;6.912670068027212
165.0;Nilsson, Bengt;1962;M4;SWE;Stockholm HHH;Drottningholm;M;567;F4 / 38;6489;6792;6996;20277;6751;6309;8297;21357;4929;6523;5359;16811;7180;9498;6183;22861;81306;196.0;2020;True;58;6.913775510204081
39.0;Kovács Nóra dr.;1970;F3;HUN;-;Budapest;F;135;N2 / 25;5720;6333;6759;18812;6530;6793;9401;22724;5091;7285;5588;17964;6160;9093;6538;21791;81291;196.0;2020;True;50;6.9125
40.0;Petroczki, Lilla;1989;F2;ROM;-;Budapest;F;447;N1 / 9;6135;6182;7088;19405;6320;6491;9037;21848;5214;0;12437;17651;6635;9085;6678;22398;81302;196.0;2020;True;31;6.9134353741496595
166.0;Robert, Costea;1986;M2;ROM;-;Barot;M;206;F1 / 14;5178;5352;6179;16709;5805;6283;10152;22240;4887;7317;6263;18467;6270;9440;8291;24001;81417;196.0;2020;True;34;6.923214285714286
167.0;Kiss Ferenc;1983;M2;HUN;-;Budapest;M;241;F2 / 30;5768;5853;7584;19205;6506;6313;9346;22165;5168;7803;6035;19006;6518;8350;6358;21226;81602;196.0;2020;True;37;6.9389455782312925
168.0;Feszt István Richárd;1993;M1;HUN;-;Budapest;M;401;F1 / 15;4845;5644;6990;17479;5360;6345;10206;21911;4684;7342;6764;18790;5929;9496;8239;23664;81844;196.0;2020;True;27;6.959523809523809
169.0;Solti Gábor;1974;M3;HUN;-;Sárvár;M;295;F3 / 80;5981;6274;6788;19043;6609;6846;10215;23670;5458;7235;5007;17700;6460;8662;6623;21745;82158;196.0;2020;True;46;6.9862244897959185
170.0;Bán László;1978;M3;HUN;-;Soltvadkert;M;209;F3 / 81;5794;6560;7024;19378;6654;6521;9136;22311;5192;7480;5676;18348;6451;8958;6860;22269;82306;196.0;2020;True;42;6.998809523809523
41.0;Varga Réka;1977;F3;HUN;-;Budapest;F;145;N2 / 26;6112;6595;7177;19884;6370;6297;9291;21958;5539;7421;5241;18201;6950;8748;6593;22291;82334;196.0;2020;True;43;7.001190476190477
171.0;Sólyom Zoltán;1972;M3;HUN;Ikarus BSE;Budapest;M;236;F3 / 82;5667;5774;6521;17962;6909;6897;10357;24163;5223;7258;5319;17800;7027;0;15425;22452;82377;196.0;2020;True;48;7.00484693877551
172.0;Rácz Róbert László;1978;M3;HUN;-;Kiskunhalas;M;180;F3 / 83;6257;6787;7329;20373;6459;6416;9641;22516;5416;6900;5443;17759;6427;8624;6777;21828;82476;196.0;2020;True;42;7.013265306122449
42.0;Balogh Szabina;1984;F2;HUN;Tapolcai Honvéd SE;Tapolca;F;467;N2 / 27;6425;6334;6823;19582;6642;6482;9328;22452;5469;7265;5381;18115;6579;8882;6878;22339;82488;196.0;2020;True;36;7.014285714285714
173.0;Ronot, Nicolas;1976;M3;FRA;-;Paris;M;509;F3 / 84;0;0;17646;17646;6451;6523;9233;22207;5055;7759;5950;18764;6760;9638;7497;23895;82512;196.0;2020;True;44;7.016326530612245
174.0;Németh-Döltl György;1990;M2;HUN;Pénzügyőr SE;Ócsa;M;298;F1 / 16;6069;6459;7021;19549;6709;6715;9195;22619;4982;7251;5339;17572;6660;9336;6896;22892;82632;196.0;2020;True;30;7.0265306122448985
43.0;Borszukovszki Anita;1975;F3;HUN;Runberries;Budapest;F;217;N2 / 28;6267;6648;7675;20590;6752;6583;9524;22859;5257;7064;5675;17996;6523;8528;6236;21287;82732;196.0;2020;True;45;7.035034013605442
175.0;Kos, Marko;1980;M3;CRO;-;Zagreb;M;535;F2 / 31;5888;5890;7661;19439;6502;7093;9667;23262;4364;7230;5956;17550;5698;9478;7589;22765;83016;196.0;2020;True;40;7.059183673469387
176.0;Schwarzwald, Hans;1964;M4;GER;THOHAN;Erfurt;M;538;F4 / 39;6230;6418;7094;19742;6628;6762;9666;23056;5318;7200;5275;17793;6547;8789;7268;22604;83195;196.0;2020;True;56;7.074404761904762
177.0;Csecsetka Dániel;1985;M2;HUN;-;Budapest;M;102;F1 / 17;6387;6858;7851;21096;6555;6392;9046;21993;5393;7578;5551;18522;6636;9033;6075;21744;83355;196.0;2020;True;35;7.088010204081633
178.0;Izsó László;1975;M3;HUN;Vidám Oroszlán;Budapest;M;101;F3 / 85;5738;6248;7735;19721;6651;7385;9555;23591;5524;7506;6203;19233;6566;8447;5975;20988;83533;196.0;2020;True;45;7.1031462585034015
179.0;Szabó Péter;1982;M2;HUN;-;Kács;M;119;F2 / 32;6434;6720;6804;19958;6467;6695;10089;23251;5603;6972;4976;17551;7342;8854;6666;22862;83622;196.0;2020;True;38;7.110714285714286
180.0;Petring, Thorsten;1969;M4;GER;-;Erfurt;M;537;F4 / 40;6227;6527;7396;20150;6628;6762;9857;23247;5314;7195;5444;17953;6583;8797;7267;22647;83997;196.0;2020;True;51;7.142602040816326
181.0;Sinkó Sándor;1972;M3;HUN;Futóbarátok Egyyesület Győr;Győr;M;440;F3 / 86;6630;6825;6645;20100;7238;0;15849;23087;5815;7572;5334;18721;7075;0;15295;22370;84278;196.0;2020;True;48;7.166496598639457
182.0;Földesi József;1957;M5;HUN;Tapolcai Honvéd SE;Tapolca;M;470;F5 / 7;6153;6411;7020;19584;6620;6658;9591;22869;0;13459;5578;19037;6954;9184;6831;22969;84459;196.0;2020;True;63;7.181887755102041
44.0;Szász Eszter;1976;F3;HUN;SUHANJ!;Budapest;F;178;N2 / 29;5849;6485;7481;19815;6412;6768;10055;23235;5404;7687;5909;19000;6574;9032;6920;22526;84576;196.0;2020;True;44;7.191836734693877
45.0;Romanova, Olga;1972;F3;RUS;-;Elektrostal;F;510;N2 / 30;5771;6169;6826;18766;6635;7248;10128;24011;5335;7385;5749;18469;6919;9515;7042;23476;84722;196.0;2020;True;48;7.204251700680272
183.0;Kvarfordt, Kjell;1959;M5;SWE;-;Sollentuna;M;566;F5 / 8;5969;6391;7289;19649;6316;6590;9760;22666;5384;8109;5793;19286;6782;9307;7478;23567;85168;196.0;2020;True;61;7.2421768707483
184.0;Takács István;1967;M4;HUN;-;Gödöllő;M;285;F4 / 41;6448;6612;7192;20252;6651;6615;9818;23084;5814;7719;5606;19139;7048;8991;6586;22625;85100;196.0;2020;True;53;7.236394557823129
185.0;Papp Tuma Attila;1965;M4;HUN;MACK;Budapest;M;411;F4 / 42;6323;6676;7260;20259;7068;6902;9460;23430;5682;7947;5440;19069;7030;8868;6628;22526;85284;196.0;2020;True;55;7.252040816326531
46.0;Pintér, Kathrin;1977;F3;GER;FER;Budapest;F;286;N2 / 31;6449;6624;7177;20250;6666;6625;9808;23099;5827;7700;5613;19140;7057;8982;6589;22628;85117;196.0;2020;True;43;7.237840136054421
186.0;Mesterházy Attila;1976;M3;HUN;-;Celldömölk;M;296;F3 / 87;5984;6285;7878;20147;6623;6864;10328;23815;5440;7503;6123;19066;6461;8593;7066;22120;85148;196.0;2020;True;44;7.240476190476191
187.0;Rogy, Johannes;1963;M4;AUT;-;Wien;M;539;F4 / 43;5791;5913;7633;19337;6341;7112;11071;24524;5573;7921;5405;18899;6931;9503;6272;22706;85466;196.0;2020;True;57;7.267517006802722
47.0;Pintér Zoltánné;1962;F4;HUN;-;Mezőhegyes;F;284;N3 / 7;6328;7239;7084;20651;6729;7071;9196;22996;5435;7711;5704;18850;6677;9684;7050;23411;85908;196.0;2020;True;58;7.305102040816326
188.0;Bars Tamás;1983;M2;HUN;-;Budapest;M;156;F2 / 33;5636;6623;7144;19403;6366;6784;9573;22723;5747;8043;5904;19694;7353;9655;7486;24494;86314;196.0;2020;True;37;7.339625850340136
189.0;Séra István;1960;M5;HUN;-;Budapest;M;36;F4 / 44;5472;6767;7618;19857;6659;7336;10351;24346;5402;8150;6200;19752;6530;9048;6927;22505;86460;196.0;2020;True;60;7.3520408163265305
190.0;Takács Csaba;1973;M3;HUN;Péceli Párducok;Pécel;M;126;F3 / 88;5788;6593;7445;19826;6668;6843;10014;23525;5531;7968;5944;19443;6842;9530;7415;23787;86581;196.0;2020;True;47;7.362329931972789
48.0;Tóth Kata;1977;F3;HUN;Csécsei Team;Rácalmás;F;248;N2 / 32;6771;6698;7293;20762;6858;7106;9538;23502;5590;7671;5614;18875;6739;9823;7108;23670;86809;196.0;2020;True;43;7.38171768707483
191.0;Havasi Imre;1984;M2;HUN;-;Békéscsaba;M;229;F2 / 34;6365;7032;7501;20898;7004;7210;9907;24121;5644;7681;5754;19079;6962;8977;7333;23272;87370;196.0;2020;True;36;7.429421768707483
192.0;Morales Castillo, Paulo;1987;M2;COL;-;Berlin;M;529;F1 / 18;6455;6502;8776;21733;6892;6552;10366;23810;5644;7847;5353;18844;6907;9637;6746;23290;87677;196.0;2020;True;33;7.4555272108843536
49.0;Farkas Izabella Dr.;1974;F3;HUN;-;Budapest;F;123;N2 / 33;6264;6436;7462;20162;6827;7109;9796;23732;5589;7893;5584;19066;7228;10175;7305;24708;87668;196.0;2020;True;46;7.454761904761905
193.0;Szalai Balázs;1974;M3;HUN;Honvéd Szondi György SE;Pápa;M;463;F3 / 89;5759;6697;6574;19030;6446;7433;10314;24193;5304;7891;6724;19919;6757;10537;7754;25048;88190;196.0;2020;True;46;7.499149659863945
194.0;Pap Csaba;1983;M2;HUN;Infopress S.E.;Budapest;M;446;F2 / 35;6422;7036;7307;20765;7022;7099;8867;22988;5721;7863;5772;19356;7333;10349;7616;25298;88407;196.0;2020;True;37;7.517602040816326
195.0;Lőrinci György;1969;M4;HUN;-;Győrújbarát;M;118;F4 / 45;6474;7028;7412;20914;6861;6871;9670;23402;5631;8361;5746;19738;7147;9684;7581;24412;88466;196.0;2020;True;51;7.522619047619048
50.0;Horváth Beáta;1993;F1;HUN;-;Zsámbok;F;212;N1 / 10;6431;6719;7333;20483;6736;0;17013;23749;5623;7876;5974;19473;7318;9983;7838;25139;88844;196.0;2020;True;27;7.554761904761905
51.0;Bálits Éva;1966;F3;HUN;-;Diósd;F;136;N3 / 8;6574;6956;7329;20859;6844;7307;10198;24349;5763;8177;5845;19785;6994;9639;7194;23827;88820;196.0;2020;True;54;7.552721088435374
196.0;Járosi Tamás;1973;M3;HUN;Zebra Futóklub;Budapest;M;412;F3 / 90;5614;7025;8561;21200;6197;6906;10393;23496;5453;8915;5992;20360;6879;9688;7738;24305;89361;196.0;2020;True;47;7.598724489795918
197.0;Hörömpő Károly ifj;1978;M3;HUN;Monorierdei Szabadidősport;Monor;M;114;F3 / 91;6291;7578;7926;21795;5415;6297;9450;21162;5593;9496;6246;21335;7241;10348;8372;25961;90253;196.0;2020;True;42;7.674574829931973
198.0;Gáti Levente;1959;M5;HUN;-----------------;Dunaharaszti;M;245;F5 / 9;6301;6619;7552;20472;7173;7301;10401;24875;5887;7977;5757;19621;7476;10573;7332;25381;90349;196.0;2020;True;61;7.682738095238095
199.0;Piszker Zoltán;1989;M2;HUN;-;Pécel;M;416;F1 / 19;6260;7737;7837;21834;6240;6815;9982;23037;6004;9322;6237;21563;7168;9731;7626;24525;90959;196.0;2020;True;31;7.734608843537415
200.0;Dobó Szilveszter;1974;M3;HUN;-;Domaszék;M;268;F3 / 92;6548;6559;7019;20126;6932;6990;10119;24041;6067;8646;6490;21203;7921;0;18726;26647;92017;196.0;2020;True;46;7.824574829931972
52.0;Szényi Sarolta;1982;F2;HUN;Sashegyi Gepárdok;Szentendre;F;403;N2 / 34;6338;6959;7495;20792;6925;7550;10263;24738;5890;8878;6423;21191;7652;10921;7580;26153;92874;196.0;2020;True;38;7.897448979591837
201.0;Petroczki, Geza Jozef;1962;M4;ROM;Ipse;Budapest;M;445;F4 / 46;6422;7235;7879;21536;7025;7194;10796;25015;5719;8894;6502;21115;7325;10370;7598;25293;92959;196.0;2020;True;58;7.904676870748299
202.0;Dely Zsolt;1972;M3;HUN;-;Enying;M;291;F3 / 93;6688;7165;7592;21445;7126;7271;10748;25145;6047;8954;6932;21933;7466;10319;8168;25953;94476;196.0;2020;True;48;8.033673469387754
203.0;Demkó Gábor;1973;M3;HUN;Monorierdei Szabadidősport;Monorierdő;M;105;F3 / 94;6293;7601;7901;21795;6781;8417;11534;26732;5596;9502;6241;21339;7231;10376;8354;25961;95827;196.0;2020;True;47;8.148554421768708
204.0;Bluecher, Tord;1958;M5;SWE;-;Storaa;M;564;F5 / 10;6625;7147;7687;21459;7375;7534;10846;25755;6196;9296;7103;22595;8171;10915;7932;27018;96827;196.0;2020;True;62;8.23358843537415
999.0;Tóth Iván Csaba;1974;M3;HUN;Fót SE Atlétika;Fót;M;430;;6869;5986;4719;17574;0;0;0;0;5612;0;12618;18230;7301;8753;6553;22607;58411;143.0;2020;False;46;6.807808857808857
999.0;Toldi Péter;1981;M2;HUN;-;Szeged;M;418;;4530;4486;4489;13505;4736;4480;6031;15247;0;0;0;0;0;0;0;0;28752;101.0;2020;False;39;4.744554455445544
999.0;Szilasy Tibor;1973;M3;HUN;Kistarcsai VRSC;Budapest;M;452;;5752;6163;7254;19169;6355;0;16927;23282;5352;0;13113;18465;0;0;0;0;60916;145.0;2020;False;47;7.00183908045977
999.0;Ménesi Tamás;1969;M4;HUN;-;Budapest;M;274;;6636;6843;7407;20886;7189;7201;10678;25068;0;0;0;0;0;0;0;0;45954;101.0;2020;False;51;7.583168316831683
999.0;Dáva Iván;1960;M5;HUN;-;Budapest;M;109;;0;0;0;0;0;0;0;0;0;0;0;0;8261;0;0;8261;8261;16.0;2020;False;60;8.605208333333334
999.0;Domán Gábor;1960;M5;HUN;Tapolca Honvéd SE;Tapolca;M;469;;4968;5897;0;10865;0;0;0;0;0;0;0;0;0;0;0;0;10865;32.0;2020;False;60;5.658854166666667
999.0;Simon Péter;1965;M4;HUN;-;Budapest;M;455;;6156;6501;7699;20356;0;0;0;0;0;0;0;0;0;0;0;0;20356;48.0;2020;False;55;7.0680555555555555
999.0;Márkus István Öcsi;1972;M3;HUN;Kadarka Futóegyesület;Szekszárd;M;251;;5138;5435;6424;16997;5883;5782;8049;19714;4364;5914;4761;15039;5997;0;0;5997;57747;161.0;2020;False;48;5.977950310559007
999.0;Horváth Csilla;1993;F1;HUN;KEFE- Komárom;Komárom;F;402;;5010;5642;7697;18349;0;0;0;0;4553;6327;4449;15329;5666;7757;5574;18997;52675;143.0;2020;False;27;6.139277389277389
999.0;Mihalicz Csaba;1975;M3;HUN;-;Gyöngyös;M;198;;5624;5995;7936;19555;0;0;0;0;0;0;0;0;0;0;0;0;19555;48.0;2020;False;45;6.789930555555556
999.0;Harrer, Karl;1958;M5;AUT;ÁWF;Sopron;M;305;;5972;6738;7842;20552;0;0;0;0;4848;6966;5086;16900;6100;8101;6457;20658;58110;143.0;2020;False;62;6.7727272727272725
999.0;Halász Krisztina;1972;F3;HUN;-;Szeged;F;221;;5518;5776;6443;17737;0;0;0;0;0;0;0;0;0;0;0;0;17737;48.0;2020;False;48;6.158680555555556
999.0;Triffault, Gilles;1979;M3;FRA;-;Beaumont De Pertuis;M;506;;6558;6776;7452;20786;6937;7008;9929;23874;5766;0;0;5766;0;0;0;0;50426;115.0;2020;False;41;7.308115942028985
999.0;Tóth István;1978;M3;HUN;Kilométergyűjtők SE;Budapest;M;202;;5664;6328;5884;17876;0;0;0;0;0;0;0;0;0;0;0;0;17876;48.0;2020;False;42;6.206944444444445
999.0;Pawel, Garncarz;1974;M3;POL;-;Wroclaw;M;508;;5106;5233;6360;16699;0;10903;8166;19069;4460;6409;4917;15786;0;0;0;0;51554;145.0;2020;False;46;5.925747126436781
999.0;Szabó Zoltán;1968;M4;HUN;SZVISE Atlétika és Triatlon;Százhalombatta;M;294;;5724;5958;6982;18664;6747;8012;0;14759;0;0;0;0;0;0;0;0;33423;80.0;2020;False;52;6.963125
999.0;Takács Gábor;1975;M3;HUN;-;Eger;M;174;;5129;5190;5323;15642;5554;5171;6999;17724;4576;6135;4572;15283;0;0;0;0;48649;145.0;2020;False;45;5.591839080459771
999.0;Peizer Szabolcs;1971;M3;HUN;BalatoniHajózás;Balatonföldvár;M;201;;5752;0;15255;21007;6660;7915;0;14575;0;0;0;0;0;0;0;0;35582;80.0;2020;False;49;7.412916666666666
999.0;Hajduk Pavol;1973;M3;SVK;-;Dolný Kubín;M;526;;5832;6494;7594;19920;0;0;0;0;4741;6732;5376;16849;7095;9573;6726;23394;60163;143.0;2020;False;47;7.012004662004662
999.0;Szabó Gábor;1976;M3;HUN;ELTE SE Sashegyi gepárdok;Budapest;M;459;;4027;3963;4027;12017;3878;3648;5103;12629;3062;3949;2978;9989;0;0;0;0;34635;145.0;2020;False;44;3.981034482758621
999.0;Garami Csongor;1968;M4;HUN;-;Törökbálint;M;124;;5603;6135;7253;18991;6318;6769;10083;23170;5119;7729;5794;18642;0;0;0;0;60803;145.0;2020;False;52;6.988850574712644
999.0;Cseh Szabolcs;1987;M2;HUN;-;Budapest;M;486;;7032;0;0;7032;7672;0;0;7672;0;0;0;0;0;0;0;0;14704;32.0;2020;False;33;7.658333333333333
999.0;Palyik Andrea;1981;F2;HUN;-;Csobánka;F;270;;6627;7000;8148;21775;0;0;0;0;0;0;0;0;0;0;0;0;21775;48.0;2020;False;39;7.560763888888889
999.0;Nyámándi Piroska;1976;F3;HUN;-;Budapest;F;312;;6402;7203;7985;21590;0;0;0;0;6239;8625;5632;20496;7257;10295;7330;24882;66968;143.0;2020;False;44;7.805128205128206
999.0;Kovács Lajos;1967;M4;HUN;Pénzügyőr SE;Budapest;M;301;;5904;6099;6664;18667;6564;6675;9524;22763;0;0;0;0;0;0;0;0;41430;101.0;2020;False;53;6.836633663366337
999.0;Geier, Jürgen;1963;M4;GER;-;Plochingen;M;520;;6525;7117;7751;21393;0;0;0;0;0;0;0;0;0;0;0;0;21393;48.0;2020;False;57;7.4281250000000005
999.0;Kiss Gábor;1980;M3;HUN;Szigetszentmiklósi Futóklub;Szigetszentmiklós;M;179;;5492;5698;6780;17970;5857;6149;9693;21699;4911;7479;0;12390;0;0;0;0;52059;132.0;2020;False;40;6.573106060606061
999.0;Molnár Richárd;1965;M4;HUN;Budaörsi DSE;Budaörs;M;457;;5486;5563;5966;17015;6199;7410;10364;23973;0;0;0;0;0;0;0;0;40988;101.0;2020;False;55;6.763696369636963
999.0;Vágóné Türei Márta;1977;F3;HUN;-;Újszilvás;F;190;;6257;6417;6676;19350;6499;6413;9055;21967;5574;7853;5672;19099;0;0;0;0;60416;145.0;2020;False;43;6.944367816091954
999.0;Fejes Tamás;1993;M1;HUN;BSC Egyesulet;Budapest;M;263;;5621;6049;7970;19640;6554;0;0;6554;4577;0;0;4577;0;0;0;0;30771;78.0;2020;False;27;6.575
999.0;Gulyás Szabolcs;1977;M3;HUN;-;Budapest;M;138;;6018;6254;6972;19244;6368;6448;9659;22475;5209;7460;5655;18324;6985;0;0;6985;67028;161.0;2020;False;43;6.938716356107661
999.0;Ispán Zsolt;1977;M3;HUN;-;Budapest;M;432;;5171;0;0;5171;0;0;0;0;0;0;0;0;0;0;0;0;5171;16.0;2020;False;43;5.386458333333334
999.0;Fosztó Zsolt;1970;M3;HUN;-;Dunakeszi;M;280;;4993;5041;5395;15429;5307;5241;7602;18150;3956;5386;3954;13296;0;0;0;0;46875;145.0;2020;False;50;5.387931034482759
999.0;Czeglédy Csaba dr.;1976;M3;HUN;-;Szombathely;M;271;;5762;6461;7893;20116;0;0;0;0;0;0;0;0;0;0;0;0;20116;48.0;2020;False;44;6.984722222222222
999.0;Bencsik Béla;1968;M4;HUN;-;Győrújbarát;M;276;;0;0;0;0;0;0;0;0;6614;9903;0;16517;7918;11608;8875;28401;44918;82.0;2020;False;52;9.129674796747967
999.0;Ozsvár Tihamér;1969;M4;HUN;-;Csantavér;M;254;;5577;5171;5740;16488;0;0;0;0;4721;6024;4394;15139;5594;0;0;5594;37221;108.0;2020;False;51;5.743981481481482
999.0;Gábriel Nikolett;1979;F3;HUN;-;Gárdony (Agárd);F;117;;6779;7676;0;14455;7608;0;0;7608;5758;0;0;5758;0;0;0;0;27821;62.0;2020;False;41;7.478763440860215
999.0;Nagy Attila;1978;M3;HUN;-;Budapest;M;227;;5956;5863;6713;18532;0;0;0;0;0;0;0;0;0;0;0;0;18532;48.0;2020;False;42;6.434722222222223
999.0;Almási Barnabás;1989;M2;HUN;-;Pécel;M;415;;6248;7701;7887;21836;0;0;0;0;6003;9329;6240;21572;7165;9726;7628;24519;67927;143.0;2020;False;31;7.916899766899766
999.0;Wiesler, Peter;1955;M5;SWE;Team Skavsärer IF;Akersberga;M;563;;0;0;0;0;0;0;0;0;0;0;0;0;0;0;0;0;0;0.0;2020;False;65;
1.0;Beda Szabolcs;1977;M3;HUN;ELTE SE Sashegyi gepárdok;Budapest;M;271;F3 / 1;3675;3791;4154;11620;3929;3824;5484;13237;3202;4478;3293;10973;3814;5248;3979;13041;48871;196.0;2019;True;42;4.155697278911565
2.0;Szőcs Előd;1994;M1;HUN;-;Vargyas;M;276;F1 / 1;4226;0;9018;13244;4314;0;10772;15086;3535;4782;3537;11854;4430;0;9687;14117;54301;196.0;2019;True;25;4.617431972789116
1.0;Cseke Lilla;1983;F2;HUN;EMU;Budapest;F;435;N2 / 1;4244;4366;4526;13136;4249;4361;6056;14666;3631;4895;3644;12170;4422;6003;4677;15102;55074;196.0;2019;True;36;4.683163265306122
3.0;Peyer Zoltán;1980;M2;HUN;Oxygen wellness;Budapest;M;459;F2 / 1;3917;4001;4363;12281;4396;4390;6430;15216;3667;4950;3719;12336;4701;6126;4637;15464;55297;196.0;2019;True;39;4.702125850340136
4.0;Toldi Péter;1981;M2;HUN;-;Szeged;M;247;F2 / 2;4584;4513;4658;13755;4662;0;10672;15334;3887;4941;3440;12268;4668;5666;3988;14322;55679;196.0;2019;True;38;4.734608843537415
5.0;Schmidt Norbert;1976;M3;HUN;Terepsport Club SE;Mór;M;230;F3 / 2;4654;4569;4798;14021;4751;4723;6448;15922;3834;4887;3532;12253;4547;5687;4227;14461;56657;196.0;2019;True;43;4.8177721088435375
6.0;Bognár Ákos dr.;1977;M3;HUN;-;Érd;M;187;F3 / 3;4582;4524;4827;13933;4656;0;11047;15703;3786;4904;3481;12171;4561;6002;4788;15351;57158;196.0;2019;True;42;4.860374149659864
7.0;Bojtor László Tivadar ifj.;1988;M2;HUN;HRSE;Debrecen Pallag;M;421;F1 / 2;4244;4372;4854;13470;4716;4619;6604;15939;3927;5037;3730;12694;4664;6000;4482;15146;57249;196.0;2019;True;31;4.868112244897959
8.0;Pintér Tibor;1977;M3;HUN;SUHANJ!;Budapest;M;455;F3 / 4;4014;4144;4608;12766;4399;4722;6729;15850;3771;5356;3679;12806;4752;6756;4412;15920;57342;196.0;2019;True;42;4.876020408163265
2.0;Hurtig, Petra;1979;F3;SWE;-;Tullinge;F;532;N2 / 2;4700;0;9467;14167;4656;4595;6475;15726;3829;5075;3650;12554;4654;6034;4480;15168;57615;196.0;2019;True;40;4.899234693877551
9.0;Dóbé Zsolt;1974;M3;HUN;-;Szeged;M;139;F3 / 5;4384;4423;4843;13650;4687;4636;6560;15883;3911;5092;3767;12770;4617;6029;4631;15277;57580;196.0;2019;True;45;4.89625850340136
10.0;Strifler Attila;1986;M2;HUN;-;Gyula;M;326;F1 / 3;4631;4603;4936;14170;4958;4822;6929;16709;3880;4884;3634;12398;4824;0;9741;14565;57842;196.0;2019;True;33;4.918537414965987
11.0;Venczel Márton;1990;M2;HUN;-;Fót;M;232;F1 / 4;4358;4478;4996;13832;4719;4768;6897;16384;3849;5232;3876;12957;4446;5804;4563;14813;57986;196.0;2019;True;29;4.93078231292517
12.0;Horváth Tamás;1986;M2;HUN;-;Dombóvár;M;325;F1 / 5;4224;4534;5511;14269;4561;4478;6904;15943;3737;5209;4281;13227;0;10375;4652;15027;58466;196.0;2019;True;33;4.971598639455782
13.0;Nagy Miklós;1968;M4;HUN;Tapolcai Honvéd SE;Sümeg;M;345;F4 / 1;4562;0;9740;14302;4836;4775;6642;16253;3876;5402;3738;13016;4667;6085;4548;15300;58871;196.0;2019;True;51;5.006037414965986
14.0;Horváth Balázs;1975;M3;HUN;-;Szombathely;M;267;F3 / 6;4459;4524;5013;13996;4706;4813;6310;15829;3867;5373;3893;13133;4767;6447;4833;16047;59005;196.0;2019;True;44;5.017431972789115
3.0;Kóródi Ágnes;1980;F2;HUN;-;Sárszentmihály;F;431;N2 / 3;4777;4890;5044;14711;4851;4809;6599;16259;4014;5334;3879;13227;4744;6082;4422;15248;59445;196.0;2019;True;39;5.05484693877551
15.0;Tóth Csaba;1973;M3;HUN;HASE;Üröm;M;447;F3 / 7;4382;0;9971;14353;4698;4734;7288;16720;3924;5121;3994;13039;4631;6116;4787;15534;59646;196.0;2019;True;46;5.071938775510204
4.0;Molnár Gitta;1983;F2;HUN;-;Békéscsaba;F;450;N2 / 4;4717;4757;5131;14605;4769;4796;6630;16195;3971;5355;3981;13307;4713;6113;4730;15556;59663;196.0;2019;True;36;5.073384353741496
16.0;Vanya Sándor;1964;M4;HUN;-;Bonyhád;M;406;F4 / 2;4560;4704;4786;14050;4901;4864;6461;16226;3930;5394;3734;13058;4794;6557;5046;16397;59731;196.0;2019;True;55;5.079166666666667
17.0;Kaluz Ákos Bertalan;1981;M2;HUN;Honvéd Szondi SE;Székesfehérvár;M;412;F2 / 3;4710;4675;5175;14560;4696;4692;6870;16258;3841;5171;3895;12907;4909;6325;4959;16193;59918;196.0;2019;True;38;5.095068027210885
18.0;Makai András;1974;M3;HUN;-;Mosonmagyaróvár;M;217;F3 / 8;4946;4920;5026;14892;4780;4655;6761;16196;3918;5233;3861;13012;4855;0;11032;15887;59987;196.0;2019;True;45;5.1009353741496595
19.0;Görgényi András;1976;M3;HUN;-;Békéscsaba;M;181;F3 / 9;4930;4854;5011;14795;4953;4822;6650;16425;4018;5291;3824;13133;4911;6335;4649;15895;60248;196.0;2019;True;43;5.12312925170068
5.0;Zétényi Szvetlana;1976;F3;HUN;Békéscsabai Atlétikai Club;Békéscsaba;F;444;N2 / 5;4933;4937;4988;14858;4988;4836;6533;16357;4138;5375;3839;13352;4896;6276;4539;15711;60278;196.0;2019;True;43;5.125680272108844
20.0;Simon György;1984;M2;HUN;-;Békéscsaba;M;330;F1 / 6;4734;0;9802;14536;4842;0;11883;16725;4018;0;9287;13305;4912;6367;4630;15909;60475;196.0;2019;True;35;5.142431972789115
21.0;Ridira, Jean-Stéphane;1975;M3;FRA;-;Pilisvörösvár;M;195;F3 / 10;0;0;14182;14182;5305;5098;6958;17361;4013;5287;3760;13060;4885;6486;4892;16263;60866;196.0;2019;True;44;5.175680272108843
6.0;Lubics Szilvia dr.;1974;F3;HUN;Kanizsai Futóklub;Nagykanizsa;F;441;N2 / 6;4991;5072;5064;15127;4960;4889;6790;16639;3981;5316;3933;13230;4928;6434;5004;16366;61362;196.0;2019;True;45;5.217857142857143
22.0;Pálfi János;1977;M3;HUN;-;Riemst;M;300;F3 / 11;4375;4558;5287;14220;4636;4809;7694;17139;3813;5291;4109;13213;4744;0;12252;16996;61568;196.0;2019;True;42;5.235374149659864
7.0;Makainé Szabó Csilla;1968;F3;HUN;HRSE;Hajdúszoboszló;F;333;N3 / 1;4964;0;10186;15150;5012;0;11609;16621;4181;5545;3991;13717;5095;6417;4724;16236;61724;196.0;2019;True;51;5.248639455782313
23.0;Kovács Ádám;1973;M3;HUN;-;Budapest;M;214;F3 / 12;4914;4923;5160;14997;5002;5041;7110;17153;4055;5385;4088;13528;5050;6718;5265;17033;62711;196.0;2019;True;46;5.332568027210884
24.0;Lódi Tamás;1978;M3;HUN;-;Budapest;M;234;F3 / 13;4949;5103;6014;16066;5230;5029;6723;16982;4268;5521;3872;13661;5063;6390;4640;16093;62802;196.0;2019;True;41;5.34030612244898
25.0;Szilvási Péter;1986;M2;HUN;Polythlon ETK;Budapest;M;201;F1 / 7;4952;0;10720;15672;4838;4805;6754;16397;4276;6061;4040;14377;4846;6650;4950;16446;62892;196.0;2019;True;33;5.34795918367347
26.0;Hadsund, Jon;1981;M2;DEN;-;Copenhagen;M;562;F2 / 4;5249;5775;5135;16159;5189;5052;6733;16974;4226;5543;3999;13768;5142;6420;4457;16019;62920;196.0;2019;True;38;5.350340136054422
27.0;Lukács Sándor;1975;M3;HUN;-;Bócsa;M;240;F3 / 14;4845;4768;4873;14486;4711;5059;6673;16443;3907;5156;3872;12935;5102;7939;6324;19365;63229;196.0;2019;True;44;5.376615646258503
28.0;Hadsund, Frej;1988;M2;DEN;-;Copenhagen;M;563;F1 / 8;5250;5777;5131;16158;5192;5056;6870;17118;4225;5544;3993;13762;5129;6339;4749;16217;63255;196.0;2019;True;31;5.378826530612245
29.0;Szász Péter;1977;M3;HUN;-;Székesfehérvár;M;213;F3 / 15;4624;4695;5461;14780;4713;4749;7664;17126;4184;5633;4171;13988;4934;6980;5641;17555;63449;196.0;2019;True;42;5.3953231292517
30.0;Giese, Ralf;1965;M4;GER;-;Stammham;M;516;F4 / 3;5389;5228;5167;15784;5402;5208;7007;17617;4359;5530;3760;13649;5208;6375;4730;16313;63363;196.0;2019;True;54;5.388010204081632
8.0;Tóth Éva;1978;F3;HUN;X2S Salomon Team;Telki;F;457;N2 / 7;4669;4808;5079;14556;4892;5012;7266;17170;4250;5779;4131;14160;5260;7090;5193;17543;63429;196.0;2019;True;41;5.393622448979592
31.0;Tóth Bálint;1979;M3;HUN;-;Budapest;M;106;F2 / 5;4929;5257;5627;15813;5026;5371;7445;17842;3977;5715;4131;13823;4729;6558;4817;16104;63582;196.0;2019;True;40;5.406632653061225
32.0;Tasnádi László;1983;M2;HUN;-;Bonyhád;M;209;F2 / 6;4773;4942;5220;14935;4761;0;12597;17358;4033;5591;4238;13862;5160;7031;5226;17417;63572;196.0;2019;True;36;5.40578231292517
33.0;Horváth Péter;1968;M4;HUN;-;Szombathely;M;445;F4 / 4;4883;4876;5160;14919;4997;4947;7089;17033;4265;0;10208;14473;5177;6830;5167;17174;63599;196.0;2019;True;51;5.408078231292517
9.0;Schmidt Adrienn;1991;F2;HUN;-;Mór;F;231;N1 / 1;5012;5158;5420;15590;4860;5043;7111;17014;4217;5652;4198;14067;5149;6872;4987;17008;63679;196.0;2019;True;28;5.414880952380952
34.0;Balázs Gergely;1985;M2;HUN;HASE;Szolnok;M;463;F1 / 9;5010;5101;5535;15646;5409;5184;7240;17833;4380;5575;3950;13905;5264;0;11214;16478;63862;196.0;2019;True;34;5.430442176870748
35.0;Stepanchuk, Vitalii;1983;M2;UKR;NRC+;Sofiivska Borschagivka;M;510;F2 / 7;5193;5100;5330;15623;5065;5098;7094;17257;4034;5571;4114;13719;5087;6752;5452;17291;63890;196.0;2019;True;36;5.4328231292517
36.0;Geréd László Ifj.;1970;M3;HUN;-;Balatonalmádi;M;466;F3 / 16;5221;5206;5474;15901;5267;5131;7273;17671;4255;5597;3947;13799;5119;6633;4878;16630;64001;196.0;2019;True;49;5.442261904761905
10.0;Losonc Tímea;1988;F2;HUN;-;Budapest;F;414;N1 / 2;5134;5178;5313;15625;5188;5274;7229;17691;4144;5688;4142;13974;5209;6668;4932;16809;64099;196.0;2019;True;31;5.450595238095238
37.0;Kracher, Hans-Peter;1980;M2;AUT;Hoadläufer Frauenkirchen;Illmitz;M;531;F2 / 8;4822;4537;5219;14578;5070;5232;7594;17896;4265;5323;4116;13704;5561;7407;5029;17997;64175;196.0;2019;True;39;5.457057823129252
38.0;Oertel Nándor;1977;M3;HUN;Zugflow;Pécel;M;342;F3 / 17;4838;4926;5205;14969;4980;4975;7396;17351;4275;6195;4238;14708;5319;6994;4990;17303;64331;196.0;2019;True;42;5.470323129251701
39.0;Takács Gábor;1975;M3;HUN;-;Eger;M;257;F3 / 18;5419;5268;5359;16046;5310;5243;6948;17501;4411;5666;4175;14252;5255;6425;4857;16537;64336;196.0;2019;True;44;5.470748299319728
40.0;Ugróczky Barna;1971;M3;HUN;-;Perenye;M;107;F3 / 19;4884;4997;5193;15074;5013;0;12816;17829;4241;5619;3979;13839;5344;6993;5270;17607;64349;196.0;2019;True;48;5.471853741496599
41.0;Gorda Zsolt;1970;M3;HUN;-;Szentendre;M;281;F3 / 20;5288;5319;5236;15843;5134;5170;7176;17480;4251;5887;4117;14255;5179;6734;4937;16850;64428;196.0;2019;True;49;5.478571428571429
42.0;Vízer Dániel;1981;M2;HUN;Fehérvári Futótűz SE;Székesfehérvár;M;332;F2 / 9;5030;5044;5442;15516;5184;5107;7367;17658;4212;5691;4269;14172;5165;6831;5152;17148;64494;196.0;2019;True;38;5.4841836734693885
43.0;Juhász Mihály Dr.;1967;M4;HUN;-;Csongrád;M;323;F4 / 5;5013;4974;5070;15057;5266;5123;6918;17307;4388;6188;4581;15157;5474;6636;5035;17145;64666;196.0;2019;True;52;5.498809523809523
44.0;Gulyás Marcell;1985;M2;HUN;-;Budapest;M;290;F1 / 10;4783;4740;5059;14582;5449;5274;7256;17979;4406;5627;4027;14060;5570;7036;5481;18087;64708;196.0;2019;True;34;5.502380952380952
45.0;Kiss Sándor;1965;M4;HUN;-;Görcsöny;M;352;F4 / 6;5052;5114;5291;15457;5019;5210;7449;17678;4236;5789;4288;14313;5235;0;12109;17344;64792;196.0;2019;True;54;5.509523809523809
11.0;Sebestyén Tímea;1978;F3;HUN;Egri Városi Sportiskola;Eger;F;410;N2 / 8;4548;4941;5418;14907;4727;5028;7386;17141;4030;5854;4470;14354;5368;7222;5816;18406;64808;196.0;2019;True;41;5.510884353741497
46.0;Dovala, Adrian;1975;M3;SVK;Drnava;Drnava;M;517;F3 / 21;4960;0;10349;15309;5188;5107;7260;17555;4490;5951;4235;14676;5530;6964;5092;17586;65126;196.0;2019;True;44;5.537925170068028
47.0;Sarus Zoltán;1983;M2;HUN;-;Szeged;M;275;F2 / 10;4966;0;10516;15482;4996;5120;8143;18259;4261;5632;4200;14093;5118;6979;5215;17312;65146;196.0;2019;True;36;5.539625850340136
48.0;Görbe István;1967;M4;HUN;-;Makó;M;402;F4 / 7;4493;5212;6624;16329;4972;4971;8348;18291;4056;5348;4164;13568;5265;6629;5085;16979;65167;196.0;2019;True;52;5.54141156462585
49.0;Kormos Attila dr.;1970;M3;HUN;-;Budapest;M;456;F3 / 22;5441;5289;5508;16238;5368;5173;7406;17947;4332;5645;4123;14100;5319;6795;4901;17015;65300;196.0;2019;True;49;5.552721088435374
50.0;Szekeres Tibor;1966;M4;HUN;Kadarka Futóegyesület;Szekszárd;M;177;F4 / 8;5334;5710;5952;16996;5352;5349;7747;18448;4204;5468;4103;13775;5075;6413;4692;16180;65399;196.0;2019;True;53;5.561139455782313
51.0;Blaskó Mihály;1980;M2;HUN;Monorierdei Szabadidősport;Monorierdő;M;353;F2 / 11;5010;4980;5067;15057;5262;5373;7782;18417;4322;5939;4129;14390;5474;7155;5294;17923;65787;196.0;2019;True;39;5.594132653061225
12.0;Kis Zita;1967;F3;HUN;Coffeerun SE;Budapest;F;426;N3 / 2;4994;5074;5538;15606;5334;5297;7350;17981;4276;5875;4437;14588;5324;7080;5212;17616;65791;196.0;2019;True;52;5.594472789115646
52.0;Bíró Attila;1978;M3;SVK;-;Dunaszerdahely;M;221;F3 / 23;4936;5082;5448;15466;5194;5102;6857;17153;4399;6277;4653;15329;5411;0;12526;17937;65885;196.0;2019;True;41;5.602465986394558
53.0;Bödő Imre;1980;M2;HUN;Honvéd Szondi György SE;Kőszeg;M;469;F2 / 12;4728;0;11004;15732;4955;5454;7734;18143;4135;5778;4336;14249;5398;7248;5144;17790;65914;196.0;2019;True;39;5.604931972789116
54.0;Tabák Péter;1969;M3;HUN;-;Budapest;M;244;F3 / 24;4963;5040;5412;15415;4994;5287;7904;18185;4355;6061;4434;14850;5607;7063;5124;17794;66244;196.0;2019;True;50;5.632993197278911
55.0;Barabás Áron;1985;M2;HUN;-;Budapest;M;319;F1 / 11;5260;5377;5464;16101;5451;5408;7219;18078;4537;5965;4108;14610;5539;6900;4981;17420;66209;196.0;2019;True;34;5.6300170068027215
56.0;Fosztó Zsolt;1970;M3;HUN;-;Dunakeszi;M;175;F3 / 25;4816;4855;5033;14704;4843;4809;8324;17976;3936;5551;4608;14095;5184;7647;6825;19656;66431;196.0;2019;True;49;5.648894557823129
57.0;Zsarkó-Berta László;1979;M3;HUN;-;Budapest;M;329;F2 / 13;5130;4977;5779;15886;5345;5660;7540;18545;4499;5817;4115;14431;5365;6988;5369;17722;66584;196.0;2019;True;40;5.661904761904762
58.0;Brown, Tomas;1988;M2;GBR;-;Bristol;M;501;F1 / 12;5085;5111;5608;15804;5269;5001;6628;16898;4347;6022;4519;14888;5574;7802;5619;18995;66585;196.0;2019;True;31;5.661989795918367
59.0;Szombathy Iván;1980;M2;HUN;Rákos-patak parti futók;Budapest;M;449;F2 / 14;4839;4929;5623;15391;5233;5157;8176;18566;4233;5736;4706;14675;5192;6835;5935;17962;66594;196.0;2019;True;39;5.6627551020408164
60.0;Bakó Gábor;1968;M4;HUN;Békési DAC;Budakalász;M;216;F4 / 9;4681;4963;5285;14929;4938;5737;8946;19621;4455;6025;4509;14989;5479;6608;5116;17203;66742;196.0;2019;True;51;5.675340136054421
13.0;Mórocza Andrea;1991;F2;HUN;-;Székesfehérvár;F;328;N1 / 3;5034;4967;5337;15338;4927;5113;7779;17819;4224;6385;4777;15386;5500;0;12795;18295;66838;196.0;2019;True;28;5.683503401360545
61.0;Kozma Zsolt;1987;M2;HUN;Esztergomi Futóművek;Tök;M;233;F1 / 13;4564;5137;6516;16217;5087;5211;7309;17607;4032;5789;4428;14249;5356;7956;5529;18841;66914;196.0;2019;True;32;5.689965986394558
62.0;Küllős Máté;1974;M3;HUN;-;Göd (Alsógöd);M;253;F3 / 26;5063;5246;5506;15815;5321;5379;7477;18177;4264;6045;4261;14570;5330;7315;5823;18468;67030;196.0;2019;True;45;5.69982993197279
63.0;Balogh Róbert;1980;M2;HUN;-;Békéscsaba;M;229;F2 / 15;4720;4968;5595;15283;5162;5260;8181;18603;4428;6087;4532;15047;5482;0;12667;18149;67082;196.0;2019;True;39;5.704251700680272
64.0;Donkó Antal;1963;M4;HUN;-;Szolnok;M;148;F4 / 10;5600;5876;5858;17334;5556;5763;7362;18681;4393;6048;4245;14686;5094;6533;4874;16501;67202;196.0;2019;True;56;5.714455782312925
14.0;Pap-Csákvári Judit;1970;F3;HUN;-;Tiszaújváros;F;405;N2 / 9;5007;5284;5503;15794;5265;5299;7322;17886;4259;5761;4758;14778;5470;7773;5451;18694;67152;196.0;2019;True;49;5.710204081632654
65.0;Tigyi László;1960;M4;HUN;SZUFLA;Budapest;M;113;F4 / 11;4911;0;10538;15449;5206;5227;7614;18047;4593;6231;4909;15733;5248;7078;5644;17970;67199;196.0;2019;True;59;5.714200680272109
66.0;Szalkai Zsolt;1974;M3;HUN;Tapolcai Honvéd SE;Tapolca;M;347;F3 / 27;5042;5097;5632;15771;5228;5247;7903;18378;4403;5819;4282;14504;5503;7333;5858;18694;67347;196.0;2019;True;45;5.726785714285715
67.0;Czingráber László;1966;M4;HUN;-;Vác;M;282;F4 / 12;5196;5356;5771;16323;5266;5362;7843;18471;4307;5990;4455;14752;5405;7106;5490;18001;67547;196.0;2019;True;53;5.743792517006803
68.0;Darányi János;1963;M4;HUN;-;Soltvadkert;M;432;F4 / 13;5377;5747;5879;17003;5417;5468;7369;18254;4320;6041;4427;14788;5424;7115;5185;17724;67769;196.0;2019;True;56;5.762670068027211
69.0;Gulyás Balázs;1983;M2;HUN;Fuss Babakocsival Egyesület;Budapest;M;154;F2 / 16;5281;5579;5852;16712;5377;5468;7783;18628;4537;6011;4545;15093;5311;7038;5134;17483;67916;196.0;2019;True;36;5.775170068027212
15.0;Csiha Yvette;1980;F2;HUN;-;Budapest;F;228;N2 / 10;5040;5236;5602;15878;5140;5138;7778;18056;4324;5948;5272;15544;5647;7378;5525;18550;68028;196.0;2019;True;39;5.78469387755102
16.0;Farkas Cecilia;1976;F3;HUN;-;Albertirsa;F;283;N2 / 11;5132;5183;5694;16009;5242;5335;7968;18545;4372;6091;4648;15111;0;13091;5523;18614;68279;196.0;2019;True;43;5.806037414965987
17.0;Katona Éva dr.;1983;F2;HUN;Kancellária SE;Pécs;F;428;N2 / 12;4990;5136;5714;15840;5205;5362;8170;18737;4425;6431;4602;15458;5587;0;12603;18190;68225;196.0;2019;True;36;5.801445578231292
18.0;Hallgató-Csík Ivett;1979;F3;HUN;-;Budapest;F;315;N2 / 13;5310;5391;5643;16344;5402;5528;8009;18939;4565;5922;4342;14829;5593;7148;5376;18117;68229;196.0;2019;True;40;5.801785714285715
70.0;Boross András;1981;M2;HUN;-;Felsőzsolca;M;134;F2 / 17;5930;6051;6030;18011;5643;5651;7720;19014;4582;5946;4219;14747;5210;6622;4947;16779;68551;196.0;2019;True;38;5.829166666666667
71.0;Hausdorf, Mike;1968;M4;GER;LG Mauerweg Berlin e.V.;Hönow;M;525;F4 / 14;5910;6108;6325;18343;6136;5702;7034;18872;4448;5770;4093;14311;5228;6890;5043;17161;68687;196.0;2019;True;51;5.840731292517007
72.0;Kertész Ervin;1970;M3;HUN;Futóbarátok Egyyesület Győr;Ásványráró;M;173;F3 / 28;5385;5664;5918;16967;5989;5748;7811;19548;4566;5689;4253;14508;5726;7025;4978;17729;68752;196.0;2019;True;49;5.84625850340136
73.0;Kasnyik Gábor;1976;M3;HUN;-;Kondoros;M;218;F3 / 29;4972;5093;5406;15471;5546;5974;8122;19642;4466;6364;4706;15536;5533;7787;4804;18124;68773;196.0;2019;True;43;5.848044217687075
74.0;Bándli Bence Dr.;1985;M2;HUN;-;Szentendre;M;112;F1 / 14;5372;5757;5873;17002;5642;5636;7551;18829;4615;6114;4409;15138;5657;7125;5228;18010;68979;196.0;2019;True;34;5.865561224489796
75.0;Hajdú Péter;1954;M5;HUN;Runberries;Budapest;M;127;F5 / 1;5664;5659;5796;17119;5467;5495;7676;18638;4394;6047;4531;14972;5519;7291;5496;18306;69035;196.0;2019;True;65;5.8703231292517
76.0;Bazsó Tibor;1970;M3;HUN;Vasi Triatlon Se.;Szombathely;M;413;F3 / 30;5296;5461;5989;16746;5534;5484;7674;18692;4505;6239;4523;15267;5579;7564;5453;18596;69301;196.0;2019;True;49;5.892942176870748
19.0;Bazsóné Pulai Ibolya;1974;F3;HUN;-;Szombathely;F;289;N2 / 14;5295;5462;5989;16746;5537;5483;7676;18696;4509;6237;4525;15271;5575;7577;5440;18592;69305;196.0;2019;True;45;5.8932823129251695
77.0;Mészáros Lajos;1962;M4;HUN;-;Eger;M;295;F4 / 15;5125;5296;5681;16102;5247;5506;7847;18600;4442;6249;4694;15385;5638;7596;5846;19080;69167;196.0;2019;True;57;5.881547619047619
78.0;Ferenczi Istvan;1977;M3;HUN;Vasas;Solymár;M;242;F3 / 31;5127;5395;6470;16992;5528;5493;8223;19244;4475;6109;4488;15072;5605;7190;5460;18255;69563;196.0;2019;True;42;5.915221088435374
79.0;Farr, Derek;1963;M4;NED;-;Zeewolde;M;528;F4 / 16;5749;0;11554;17303;5738;5622;7633;18993;4735;6146;4424;15305;5668;7124;5106;17898;69499;196.0;2019;True;56;5.909778911564626
20.0;Varga Szilvia;1974;F3;HUN;-;Érd;F;125;N2 / 15;5336;0;11167;16503;5556;5598;7777;18931;0;10789;4517;15306;5755;7617;5593;18965;69705;196.0;2019;True;45;5.927295918367347
80.0;Kollár Zoltán;1965;M4;HUN;Knorr-Bremse;Budapest;M;55;F4 / 17;5747;5797;6162;17706;5841;5792;7608;19241;4796;6127;4362;15285;5583;6951;5013;17547;69779;196.0;2019;True;54;5.9335884353741495
21.0;Kertész Adrienn;1971;F3;HUN;Honvéd Sas-hegy SE;Budapest;F;259;N2 / 16;4902;5703;6417;17022;5215;5826;8183;19224;4501;6665;4728;15894;5328;7304;5371;18003;70143;196.0;2019;True;48;5.96454081632653
81.0;Lars-Aake, Johansson;1970;M3;SWE;Team Sweden;Bohus;M;564;F3 / 32;5164;5313;6047;16524;5458;5705;8737;19900;4357;5997;4407;14761;5461;7327;5808;18596;69781;196.0;2019;True;49;5.933758503401361
82.0;Csepregi Ákos;1983;M2;HUN;-;Budapest;M;204;F2 / 18;5435;5572;6222;17229;5396;5545;7976;18917;4455;6117;4511;15083;5563;7398;5648;18609;69838;196.0;2019;True;36;5.938605442176871
83.0;Major Balázs;1974;M3;HUN;-;Budapest;M;256;F3 / 33;5528;5501;5928;16957;5680;0;13907;19587;4598;6134;4414;15146;5649;7185;5336;18170;69860;196.0;2019;True;45;5.94047619047619
84.0;Lévai Péter;1967;M4;HUN;-;Maklár;M;156;F4 / 18;5373;5743;5854;16970;5276;5411;8112;18799;4286;6107;4672;15065;5341;7591;6263;19195;70029;196.0;2019;True;52;5.9548469387755105
85.0;Taksonyi Szilárd;1971;M3;HUN;-;Szekszárd;M;424;F3 / 34;5404;5682;6200;17286;5538;5630;7495;18663;4685;6095;4437;15217;5847;7503;5442;18792;69958;196.0;2019;True;48;5.9488095238095235
86.0;Láng István;1957;M5;HUN;Gödi Futóklub;Göd (Alsógöd);M;30;F5 / 2;5632;5893;6163;17688;5666;5593;7442;18701;4563;0;10473;15036;5678;7510;5494;18682;70107;196.0;2019;True;62;5.961479591836735
87.0;Zsíros Ákos;1976;M3;HUN;-;Dunakeszi;M;236;F3 / 35;5463;5453;5662;16578;5905;5654;7568;19127;4597;6343;4703;15643;5799;7486;5823;19108;70456;196.0;2019;True;43;5.9911564625850335
88.0;Bikfalvi Péter;1982;M2;HUN;-;Budapest;M;318;F2 / 19;5812;0;12107;17919;5962;5876;7828;19666;4813;6231;4265;15309;5772;7496;4575;17843;70737;196.0;2019;True;37;6.015051020408164
89.0;Durugy András;1968;M4;HUN;-;Budapest;M;220;F4 / 19;5665;5674;5839;17178;5636;5754;8045;19435;4732;6257;4616;15605;5712;0;12836;18548;70766;196.0;2019;True;51;6.017517006802722
22.0;Jakab Enikő;1973;F3;HUN;-;Székelyudvarhely;F;131;N2 / 17;5511;6575;6346;18432;5352;5713;7718;18783;4394;6031;4431;14856;5495;7585;5706;18786;70857;196.0;2019;True;46;6.025255102040816
90.0;Pszota Attila;1979;M3;HUN;-;Kiskőrös;M;251;F2 / 20;5284;5356;5871;16511;5571;5782;8013;19366;4629;6586;4665;15880;5720;7650;5840;19210;70967;196.0;2019;True;40;6.034608843537415
91.0;Simon Zoltán;1970;M3;HUN;-;Solymár;M;37;F3 / 36;5675;5871;6192;17738;5895;5672;7707;19274;4770;6293;4490;15553;5757;7402;5278;18437;71002;196.0;2019;True;49;6.037585034013605
92.0;Rudolf József dr.;1970;M3;HUN;-;Budapest;M;185;F3 / 37;5463;5650;5871;16984;5624;5778;8359;19761;4654;6771;4685;16110;5623;7260;5457;18340;71195;196.0;2019;True;49;6.053996598639455
93.0;Berei Tibor László;1976;M3;HUN;-;Szigetszentmiklós;M;188;F3 / 38;5337;5433;6029;16799;5544;5912;8559;20015;4653;6123;4904;15680;5473;0;13187;18660;71154;196.0;2019;True;43;6.050510204081633
94.0;Gáspár András Zoltán;1974;M3;HUN;KEFE- Komárom;Érd;M;186;F3 / 39;5751;5741;5983;17475;5583;5500;8053;19136;4790;6244;4708;15742;5740;7522;5488;18750;71103;196.0;2019;True;45;6.046173469387755
23.0;Fehérvári Kata;1982;F2;HUN;Runberries;Budapest;F;180;N2 / 18;5582;5798;5997;17377;5647;5738;7983;19368;4742;6493;4547;15782;5718;7488;5477;18683;71210;196.0;2019;True;37;6.055272108843537
95.0;Gelencsér Zoltán Tibor;1965;M4;HUN;Tapolcai Honvéd SE;Keszthely;M;344;F4 / 20;5687;5628;6441;17756;5616;5751;8297;19664;4528;6265;4728;15521;5580;7267;5574;18421;71362;196.0;2019;True;54;6.068197278911564
24.0;Rasmussen, Sanne;1987;F2;DEN;-;Křbenhavn S;F;561;N1 / 4;5838;5921;5973;17732;5805;5699;7892;19396;4745;6223;4461;15429;5720;7508;5618;18846;71403;196.0;2019;True;32;6.071683673469387
96.0;Sipos Sándor;1957;M5;HUN;HASE;Budapest;M;409;F5 / 3;5624;5679;5798;17101;5630;5633;7814;19077;4581;6417;4781;15779;5885;7833;5916;19634;71591;196.0;2019;True;62;6.087670068027212
97.0;Czaltig Zsolt;1974;M3;HUN;-;Lajoskomárom;M;136;F3 / 40;5460;5511;6011;16982;5768;5652;8801;20221;4738;6313;4620;15671;5937;7391;5515;18843;71717;196.0;2019;True;45;6.098384353741497
98.0;Pető András ifj;1976;M3;HUN;-;Hatvan;M;454;F3 / 41;5642;0;11814;17456;5706;5800;8112;19618;4528;6493;4695;15716;5713;7629;5656;18998;71788;196.0;2019;True;43;6.104421768707483
99.0;Hugyecz Attila;1969;M3;HUN;Gödi Futóklub;Kosd;M;157;F3 / 42;5372;5706;6512;17590;5789;6191;8537;20517;4693;6241;4710;15644;5673;7248;5250;18171;71922;196.0;2019;True;50;6.115816326530613
25.0;Fekete Krisztina;1973;F3;HUN;21 Nő az Egészségügyért;Budapest;F;159;N2 / 19;5653;5665;5724;17042;5787;5785;8012;19584;4859;6489;4632;15980;5957;7882;5740;19579;72185;196.0;2019;True;46;6.138180272108843
100.0;Balog Andor;1983;M2;HUN;-;Tatabánya;M;307;F2 / 21;4780;5265;5838;15883;5412;6536;8839;20787;4453;6866;4520;15839;5690;8280;6216;20186;72695;196.0;2019;True;36;6.181547619047619
101.0;Halvax Péter;1987;M2;HUN;-;Kaposvár;M;312;F1 / 15;5304;0;11583;16887;5835;5971;8253;20059;4715;6447;4702;15864;5741;7719;6004;19464;72274;196.0;2019;True;32;6.145748299319727
102.0;Fekete Attila;1981;M2;SVK;-;Dunaszerdahely;M;178;F2 / 22;5621;6253;6274;18148;5718;5645;7836;19199;4814;6443;4668;15925;5726;7602;5610;18938;72210;196.0;2019;True;38;6.14030612244898
103.0;Papp László;1963;M4;HUN;Tapolcai Honvéd SE;Budapest;M;470;F4 / 21;5367;5284;5767;16418;5602;5764;8538;19904;4732;6782;5120;16634;5862;7829;5736;19427;72383;196.0;2019;True;56;6.155017006802722
104.0;Sutyinszky Tamás;1972;M3;HUN;-;Budapest;M;151;F3 / 43;5492;5642;5909;17043;5853;5805;8111;19769;4770;6497;4687;15954;5966;7738;5840;19544;72310;196.0;2019;True;47;6.148809523809525
105.0;Hoskó Roland;1976;M3;HUN;-;Budapest;M;211;F3 / 44;4993;5154;5981;16128;5210;5858;8593;19661;4402;6666;5095;16163;5863;8286;6244;20393;72345;196.0;2019;True;43;6.151785714285714
26.0;Sima Éva;1961;F4;HUN;PAFF;Paks;F;429;N3 / 3;5433;5776;5997;17206;5911;5831;8047;19789;4792;6574;4515;15881;5924;7953;5866;19743;72619;196.0;2019;True;58;6.175085034013605
106.0;Kovács Tamás;1970;M3;HUN;-;Budapest;M;303;F3 / 45;5306;5536;6052;16894;5367;5747;8229;19343;4627;6455;4864;15946;6167;8625;5882;20674;72857;196.0;2019;True;49;6.1953231292517
107.0;Oberling Ákos;1987;M2;HUN;-;Bokod;M;292;F1 / 16;5577;5475;5699;16751;5582;5703;9035;20320;4492;6138;4838;15468;5966;8020;6357;20343;72882;196.0;2019;True;32;6.197448979591837
27.0;Balázsiné Boros Linda Anna;1979;F3;HUN;-;Érd;F;415;N2 / 20;5324;5558;5848;16730;5745;5976;8331;20052;4827;7044;4771;16642;5681;7804;6141;19626;73050;196.0;2019;True;40;6.211734693877551
108.0;Pálfi László ifj;1977;M3;HUN;Hegyalja2050 SE;Kazincbarcika;M;227;F3 / 46;5599;5731;7004;18334;5921;5935;7964;19820;4679;6472;4559;15710;5862;7627;5576;19065;72929;196.0;2019;True;42;6.201445578231293
109.0;Deli Tamás;1976;M3;HUN;-;Leányfalu;M;179;F3 / 47;5467;5653;6558;17678;5358;5405;8353;19116;4330;0;11390;15720;5774;8638;6207;20619;73133;196.0;2019;True;43;6.218792517006803
110.0;Vasas Levente;1981;M2;HUN;-;Kecskemét;M;215;F2 / 23;5136;0;11762;16898;5755;6116;8731;20602;4937;6958;4816;16711;5639;7627;5639;18905;73116;196.0;2019;True;38;6.21734693877551
28.0;Hangya Andrea;1978;F3;HUN;Zebra Futóklub;Budapest;F;155;N2 / 21;5622;5758;5985;17365;5963;5969;7822;19754;5016;6765;4904;16685;6187;7755;5716;19658;73462;196.0;2019;True;41;6.2467687074829925
111.0;Major Tibor dr.;1960;M4;HUN;-;Budapest;M;222;F4 / 22;5593;0;12033;17626;5685;5865;8692;20242;4623;6510;5060;16193;5633;7675;6022;19330;73391;196.0;2019;True;59;6.240731292517007
112.0;Tamas Knapp Mr.;1983;M2;HUN;-;Den Haag;M;522;F2 / 24;5252;5507;6518;17277;5625;6224;9976;21825;4699;6254;4569;15522;5780;7378;5614;18772;73396;196.0;2019;True;36;6.2411564625850335
113.0;Juodagalvis, Vytautas;1983;M2;LIT;AlkoBikers;Grindelwald;M;533;F2 / 25;5357;5287;5689;16333;5438;5794;8314;19546;4618;6733;5261;16612;5986;8411;6589;20986;73477;196.0;2019;True;36;6.248044217687074
114.0;Kopecsni Attila;1992;M1;HUN;HOSOSZ;Budapest;M;349;F1 / 17;4824;0;11112;15936;5394;5745;9150;20289;4905;7056;5617;17578;5712;0;14031;19743;73546;196.0;2019;True;27;6.2539115646258505
115.0;Preil József;1978;M3;HUN;Fehérvári Futótűz SE;Székesfehérvár;M;310;F3 / 48;5149;5117;5589;15855;5748;6339;8811;20898;4668;6740;4625;16033;5986;8837;6119;20942;73728;196.0;2019;True;41;6.2693877551020405
116.0;Salamon István;1962;M4;HUN;-;Mezőtárkány;M;34;F4 / 23;6080;6209;6359;18648;6024;5964;8347;20335;4759;6210;4664;15633;5787;7538;5885;19210;73826;196.0;2019;True;57;6.277721088435374
117.0;Sebestyén Ádám Dr.;1973;M3;HUN;-;Budapest;M;203;F3 / 49;5320;5516;5928;16764;5714;6109;8948;20771;4640;6299;4660;15599;6202;8455;6062;20719;73853;196.0;2019;True;46;6.280017006802722
118.0;Török Benjamin;1992;M1;HUN;Pécsi testkultúra Közhasznú Egyesület;Budapest;M;446;F1 / 18;4613;0;14008;18621;5904;5305;8721;19930;4171;7067;5465;16703;5191;7339;6069;18599;73853;196.0;2019;True;27;6.280017006802722
119.0;Szabó Norbert;1977;M3;HUN;-;Leányfalu;M;174;F3 / 50;5380;0;11820;17200;5579;5971;9119;20669;4590;6226;4891;15707;5765;7856;6693;20314;73890;196.0;2019;True;42;6.283163265306122
29.0;Komjáti-Lajkó Mónika;1973;F3;HUN;Tapolcai Honvéd SE;Jánoshalma;F;460;N2 / 22;5575;0;11640;17215;5829;0;14160;19989;4951;6549;4818;16318;6037;8093;6252;20382;73904;196.0;2019;True;46;6.284353741496599
120.0;Hegedűs Zoltán;1978;M3;HUN;KEFE- Komárom;Budapest;M;129;F3 / 51;6127;6290;6188;18605;6167;5945;8065;20177;4892;6590;4675;16157;5897;7494;5628;19019;73958;196.0;2019;True;41;6.288945578231293
30.0;Nagy Dóra Mária;1988;F2;HUN;-;Budapest;F;121;N1 / 5;5501;5554;6320;17375;5590;5932;8251;19773;4873;7056;4820;16749;6127;8270;6006;20403;74300;196.0;2019;True;31;6.318027210884353
121.0;Pitsch, Udo;1953;M5;GER;TG Viktoria Augsburg;Wehringen;M;524;F5 / 4;6142;6119;6249;18510;6172;6080;8225;20477;5007;6695;4793;16495;6004;7591;5425;19020;74502;196.0;2019;True;66;6.335204081632654
122.0;Barabás László;1970;M3;HUN;Szigetszentmiklósi Futóklub;Szigetszentmiklós;M;208;F3 / 52;5410;5685;6258;17353;5714;5915;9286;20915;4632;6524;5121;16277;5658;8157;6485;20300;74845;196.0;2019;True;49;6.36437074829932
123.0;Tóth István;1978;M3;HUN;Kilométergyűjtők SE;Budapest;M;433;F3 / 53;5459;5509;6571;17539;5732;5822;8720;20274;4929;6542;4720;16191;6441;8276;6274;20991;74995;196.0;2019;True;41;6.3771258503401365
124.0;Lajszner Lajos;1966;M4;HUN;Egri triatlon klub;Eger;M;163;F4 / 24;5808;6101;6602;18511;6020;6075;8682;20777;4838;6595;4762;16195;5953;7995;5737;19685;75168;196.0;2019;True;53;6.391836734693877
125.0;Zömbik László;1961;M4;HUN;Keszthelyi Kilométerek;Keszthely;M;138;F4 / 25;6065;0;12653;18718;5789;5822;8087;19698;4968;0;11813;16781;6012;8160;5987;20159;75356;196.0;2019;True;58;6.407823129251701
126.0;Kadenszky Zsolt;1972;M3;HUN;Péceli Párducok;Pécel;M;287;F3 / 54;5885;5981;6267;18133;6190;5990;8675;20855;5408;6863;5164;17435;5783;7585;5468;18836;75259;196.0;2019;True;47;6.399574829931972
127.0;Ludman Péter;1992;M1;HUN;-;Budapest;M;273;F1 / 19;4637;5033;6004;15674;4979;5783;9106;19868;4451;6937;5604;16992;6214;9459;7247;22920;75454;196.0;2019;True;27;6.416156462585033
128.0;Szocsevka Gábor;1984;M2;HUN;Honvéd Ezüstnyíl SE;Csót;M;461;F2 / 26;5180;5569;6233;16982;5623;5961;8820;20404;4904;6949;5124;16977;6326;8680;5981;20987;75350;196.0;2019;True;35;6.407312925170068
129.0;Burdov, Alexey;1971;M3;RUS;IRC;Moscow;M;527;F3 / 55;6192;6052;6134;18378;5988;0;14492;20480;4909;6519;4784;16212;6078;0;14249;20327;75397;196.0;2019;True;48;6.411309523809523
130.0;Gyetkó Zoltán;1983;M2;HUN;-;Budapest;M;286;F2 / 27;5596;6124;6821;18541;5457;6079;8808;20344;4888;7140;5242;17270;5687;7705;6214;19606;75761;196.0;2019;True;36;6.442261904761905
131.0;Béry Norbert;1970;M3;HUN;-;Söpte;M;116;F3 / 56;5209;5622;6440;17271;5399;5732;9468;20599;4516;7393;5073;16982;5656;8858;6278;20792;75644;196.0;2019;True;49;6.432312925170068
132.0;Márkus Levente;1996;M1;HUN;-;Szeged;M;142;F1 / 20;6184;6219;6437;18840;6198;6030;8253;20481;4900;6665;4823;16388;6288;7862;5840;19990;75699;196.0;2019;True;23;6.436989795918368
133.0;Varga Miklós;1982;M2;HUN;-;Szeged (Kiskundorozsma);M;143;F2 / 28;6183;6217;6440;18840;6194;0;14283;20477;4905;6675;4815;16395;6292;7836;5875;20003;75715;196.0;2019;True;37;6.438350340136055
134.0;Szabó Balázs dr.;1970;M3;HUN;Iron Team;Budapest;M;140;F3 / 57;5805;6064;6303;18172;6249;6197;8388;20834;5103;6673;4968;16744;6301;8060;5990;20351;76101;196.0;2019;True;49;6.471173469387755
31.0;Halász Krisztina;1972;F3;HUN;-;Szeged;F;268;N2 / 23;5656;5893;6765;18314;5915;5999;9171;21085;4825;6798;5305;16928;5748;8007;6089;19844;76171;196.0;2019;True;47;6.477125850340136
32.0;Pöltz Hajnalka dr.;1973;F3;HUN;Futóbarátok - Nike Futóklub Győr;Győr;F;264;N2 / 24;5735;6114;6661;18510;6219;6427;8026;20672;4736;6857;4722;16315;6126;8602;6310;21038;76535;196.0;2019;True;46;6.508078231292517
135.0;Oldenburg, Jens;1971;M3;GER;-;Berlin;M;523;F3 / 58;5792;0;12056;17848;6166;6047;8590;20803;5111;6732;4815;16658;6189;8746;6704;21639;76948;196.0;2019;True;48;6.543197278911565
33.0;Fodor Ágnes;1976;F3;HUN;-;Debrecen;F;316;N2 / 25;5467;6101;6563;18131;5845;6268;8770;20883;4987;7037;5216;17240;6064;8356;6204;20624;76878;196.0;2019;True;43;6.537244897959184
136.0;Kern Attila Lajos;1978;M3;HUN;Flow SC;Budapest;M;407;F3 / 59;6152;6026;6094;18272;6053;0;14486;20539;5026;7006;5338;17370;6428;8561;6298;21287;77468;196.0;2019;True;41;6.587414965986395
137.0;Klam Csaba;1970;M3;HUN;-;Soltvadkert;M;29;F3 / 60;5843;5873;6169;17885;6022;6089;9015;21126;4936;7094;5501;17531;6319;0;14514;20833;77375;196.0;2019;True;49;6.579506802721088
138.0;Simon Péter;1965;M4;HUN;-;Budapest;M;442;F4 / 26;5438;5614;6546;17598;5549;6174;9557;21280;4750;6920;5495;17165;5921;8841;6795;21557;77600;196.0;2019;True;54;6.598639455782313
34.0;Hugyecz Attiláné;1970;F3;HUN;Gödi Futóklub;Kosd;F;158;N2 / 26;5558;5959;6881;18398;6074;0;15401;21475;4848;7077;5107;17032;5866;8390;6493;20749;77654;196.0;2019;True;49;6.603231292517007
35.0;Bíró Henrietta;1975;F3;HUN;-;Göd (Felsőgöd);F;440;N2 / 27;5375;6240;7313;18928;6353;6169;8810;21332;4946;6728;4974;16648;6180;8530;6089;20799;77707;196.0;2019;True;44;6.607738095238095
139.0;Kiss Gábor;1980;M2;HUN;Szigetszentmiklósi Futóklub;Szigetszentmiklós;M;226;F2 / 29;5410;6672;6098;18180;5712;6156;10662;22530;4657;6730;4932;16319;5661;8630;6400;20691;77720;196.0;2019;True;39;6.608843537414965
140.0;Pók András;1987;M2;HUN;-;Budapest;M;161;F1 / 21;5870;5777;6089;17736;5930;0;14136;20066;4852;7712;5714;18278;6634;9387;5979;22000;78080;196.0;2019;True;32;6.6394557823129245
141.0;Pók János;1963;M4;HUN;Axiál Kft.;Gárdony (Agárd);M;33;F4 / 27;5872;5772;6093;17737;5938;6011;8121;20070;4855;7715;5717;18287;6638;9390;5979;22007;78101;196.0;2019;True;56;6.6412414965986395
36.0;Nagy Izabella dr.;1984;F2;HUN;-;Budapest;F;296;N1 / 6;6016;6239;6488;18743;6236;6301;9105;21642;5268;7128;4994;17390;6516;7971;5825;20312;78087;196.0;2019;True;35;6.640051020408164
37.0;Hajdu Krisztina Dr.;1971;F3;HUN;-;Szombathely;F;109;N2 / 28;5413;5899;6221;17533;5599;6117;9259;20975;4843;7115;5470;17428;6121;9088;7101;22310;78246;196.0;2019;True;48;6.6535714285714285
142.0;Tomaj László;1974;M3;HUN;-;Rácalmás;M;263;F3 / 61;5413;5904;6216;17533;5597;6118;9259;20974;4843;7115;5471;17429;6120;9097;7093;22310;78246;196.0;2019;True;45;6.6535714285714285
143.0;Tomik Balázs;1977;M3;HUN;-;Tarnaméra;M;313;F3 / 62;6181;6231;6538;18950;6299;6418;9514;22231;5101;7121;5186;17408;6074;0;13973;20047;78636;196.0;2019;True;42;6.6867346938775505
144.0;Németh Imre;1972;M3;HUN;-;Budapest;M;451;F3 / 63;5840;0;12087;17927;5864;6349;9055;21268;5041;7032;5428;17501;6572;9249;6150;21971;78667;196.0;2019;True;47;6.689370748299319
38.0;Brokat, Helga;1953;F4;GER;LG Mauerweg Berlin;Berlin;F;571;N4 / 1;6312;6510;7399;20221;6408;6511;9020;21939;5182;6830;4775;16787;6254;7730;5753;19737;78684;196.0;2019;True;66;6.690816326530613
39.0;Juhász Zita;1968;F3;HUN;-;Dunakeszi;F;200;N3 / 4;6243;6347;6602;19192;6313;6338;8605;21256;5258;7202;5115;17575;6192;8058;6493;20743;78766;196.0;2019;True;51;6.697789115646258
40.0;Schneller Erika;1968;F3;HUN;-;Szentendre;F;114;N3 / 5;5956;6138;6525;18619;6161;6461;8943;21565;5074;7197;5015;17286;6251;8741;6307;21299;78769;196.0;2019;True;51;6.698044217687075
145.0;Vincze Elemér;1977;M3;HUN;-;Nyíregyháza;M;123;F3 / 64;6226;6445;6823;19494;6371;6356;9381;22108;5135;6992;5104;17231;6178;7993;6011;20182;79015;196.0;2019;True;42;6.718962585034014
41.0;Harmati Zsanna;1976;F3;HUN;-;Dunakeszi;F;434;N2 / 29;6246;6346;6602;19194;6312;6338;8624;21274;5263;7229;5361;17853;6190;8069;6479;20738;79059;196.0;2019;True;43;6.722704081632654
146.0;Szabó Zsolt;1973;M3;HUN;-;Budapest;M;416;F3 / 65;6327;6674;7119;20120;6667;6675;9708;23050;5178;6623;4923;16724;6082;7596;5677;19355;79249;196.0;2019;True;46;6.738860544217687
146.0;Járosi Tamás;1973;M3;HUN;Zebra Futóklub;Budapest;M;150;F3 / 65;5033;5955;7324;18312;5380;6622;9711;21713;4722;7249;5412;17383;6307;9456;6045;21808;79216;196.0;2019;True;46;6.736054421768707
148.0;Fekete Ádám;1969;M3;HUN;-;Tata;M;403;F3 / 67;6210;6514;7350;20074;6238;6286;9046;21570;5079;7147;5179;17405;6427;8008;5884;20319;79368;196.0;2019;True;50;6.748979591836735
149.0;Horváth Attila;1974;M3;HUN;Futóbarátok - Nike Futóklub Győr;Győr;M;265;F3 / 68;5736;6117;6657;18510;6216;6532;9155;21903;5397;7438;5254;18089;6150;8577;6301;21028;79530;196.0;2019;True;45;6.762755102040816
150.0;Pozderka Attila;1978;M3;HUN;HASE;Budapest;M;348;F3 / 69;6188;6463;6445;19096;6395;6562;8398;21355;5629;7221;4985;17835;6562;8521;6175;21258;79544;196.0;2019;True;41;6.763945578231293
151.0;Keresztesi Tamás;1983;M2;HUN;Ironteam SE;Rácalmás;M;309;F2 / 30;5959;6155;6578;18692;6321;6361;8397;21079;5069;6946;5285;17300;6522;9132;6886;22540;79611;196.0;2019;True;36;6.769642857142856
152.0;Földesi József;1957;M5;HUN;Tapolcai Honvéd SE;Tapolca;M;343;F5 / 5;5798;6033;6676;18507;6073;6432;9040;21545;5193;7292;5335;17820;6453;8857;6503;21813;79685;196.0;2019;True;62;6.775935374149659
42.0;Viniczai Andrea;1976;F3;HUN;SUHANJ!;Budapest;F;152;N2 / 30;6127;6287;6340;18754;6360;6420;8984;21764;5264;7142;5143;17549;6550;8787;6401;21738;79805;196.0;2019;True;43;6.786139455782313
153.0;Mihalik Zoltán;1979;M3;HUN;-;Budapest;M;452;F2 / 31;6473;6465;7118;20056;6102;6405;8714;21221;4965;7190;5222;17377;6331;8721;6268;21320;79974;196.0;2019;True;40;6.800510204081633
43.0;Ganter-Kaufmann, Inge;1966;F3;GER;Team Kaufmann;Schramberg;F;505;N3 / 6;5580;5970;6691;18241;6393;6765;9384;22542;5196;7082;5209;17487;6259;8102;7397;21758;80028;196.0;2019;True;53;6.805102040816326
44.0;Romanova, Olga;1972;F3;RUS;-;Elektrostal;F;526;N2 / 31;6138;6309;6419;18866;6202;6464;8778;21444;5249;7333;5421;18003;6470;8917;6356;21743;80056;196.0;2019;True;47;6.8074829931972785
154.0;Farkas László;1967;M4;HUN;-;Budapest;M;20;F4 / 28;6066;6221;6763;19050;6357;6417;8986;21760;5259;7139;5143;17541;6545;8784;6403;21732;80083;196.0;2019;True;52;6.809778911564626
155.0;Soós Péter;1970;M3;HUN;Tapolcai Honvéd SE;Székesfehérvár;M;346;F3 / 70;5880;6396;6658;18934;6028;6483;9202;21713;4991;7123;5344;17458;6438;8816;6872;22126;80231;196.0;2019;True;49;6.822363945578232
156.0;Nagy Béla;1962;M4;HUN;-;Sopron;M;164;F4 / 29;5744;6094;6656;18494;6105;6461;9099;21665;5082;7508;5301;17891;6482;9115;6593;22190;80240;196.0;2019;True;57;6.82312925170068
157.0;Benedek Péter;1975;M3;HUN;-;Budapest;M;299;F3 / 71;5601;5865;6736;18202;5808;6639;10033;22480;4899;7280;5669;17848;6203;9070;6569;21842;80372;196.0;2019;True;44;6.8343537414965985
158.0;Izsó László;1975;M3;HUN;Vidám Oroszlán;Budapest;M;115;F3 / 72;5842;5939;6521;18302;6327;6574;9661;22562;0;12495;5284;17779;0;14968;6981;21949;80592;196.0;2019;True;44;6.853061224489796
159.0;Dobák Zsolt;1980;M2;HUN;-;Tatabánya;M;252;F2 / 32;6312;6140;6503;18955;6321;6702;9972;22995;5313;7198;5353;17864;6408;8397;6295;21100;80914;196.0;2019;True;39;6.880442176870748
45.0;Schunke Bleiss, Sandra;1975;F3;GER;Multisport-LOS e.V.;Berlin;F;512;N2 / 32;5913;6100;7083;19096;6160;6759;10604;23523;5202;7585;5875;18662;5738;7448;6526;19712;80993;196.0;2019;True;44;6.887159863945579
46.0;Bergmann, Heike;1962;F4;GER;Lauffeuer Fröttstädt;Zeulenroda-Triebes;F;530;N3 / 7;5915;6094;6332;18341;6151;6732;9517;22400;5230;7525;5384;18139;6404;9397;6296;22097;80977;196.0;2019;True;57;6.885799319727891
160.0;Szabó Zoltán;1968;M4;HUN;SZVISE Atlétika és Triatlon;Százhalombatta;M;160;F4 / 30;5562;5916;7167;18645;5887;6449;9801;22137;5008;7443;5578;18029;6146;9209;6868;22223;81034;196.0;2019;True;51;6.890646258503401
161.0;Gyenge Péter;1978;M3;HUN;-;Dunakeszi;M;291;F3 / 73;5737;5724;6097;17558;6118;6349;9850;22317;5531;7653;5684;18868;6776;8992;6651;22419;81162;196.0;2019;True;41;6.9015306122448985
162.0;Székely Loránd;1979;M3;HUN;-;Kecskemét;M;285;F2 / 33;6241;6407;6656;19304;6397;6528;9167;22092;5314;7305;5023;17642;6762;9173;6195;22130;81168;196.0;2019;True;40;6.90204081632653
47.0;Kovács Nóra dr.;1970;F3;HUN;-;Budapest;F;184;N2 / 33;5945;6471;6630;19046;6223;6806;9293;22322;4917;7301;5488;17706;6345;8949;6809;22103;81177;196.0;2019;True;49;6.90280612244898
163.0;Gyárfás Zsolt;1967;M4;HUN;-;Eger;M;235;F4 / 31;6614;6668;6913;20195;6716;6651;8933;22300;5582;6971;5033;17586;6695;8291;6128;21114;81195;196.0;2019;True;52;6.904336734693878
48.0;Dósa Réka;1988;F2;HUN;-;Budapest;F;241;N1 / 7;6141;6386;6418;18945;6399;6706;8702;21807;5400;7499;5216;18115;6746;9055;6699;22500;81367;196.0;2019;True;31;6.918962585034013
49.0;Porpáczy Tímea;1986;F2;HUN;-;Szombathely;F;419;N1 / 8;6183;6438;6831;19452;6136;6281;9241;21658;5050;7230;5440;17720;6603;9104;6981;22688;81518;196.0;2019;True;33;6.931802721088436
164.0;Berger Tamás;1980;M2;HUN;Honvéd Szondi SE;Székesfehérvár;M;467;F2 / 34;6175;6266;7046;19487;6321;6451;10106;22878;5250;7051;5230;17531;6500;0;15195;21695;81591;196.0;2019;True;39;6.938010204081632
165.0;Schilt László ifj;1994;M1;HUN;-;Kaposvár-Toponár;M;311;F1 / 22;5093;5680;6637;17410;5734;6388;10064;22186;4949;7611;5237;17797;6892;10016;7474;24382;81775;196.0;2019;True;25;6.953656462585035
50.0;Mátyás Bernadett;1982;F2;HUN;-;Szolnok;F;462;N2 / 34;6362;6475;6824;19661;6378;6752;9790;22920;5381;7438;5273;18092;6438;8552;6251;21241;81914;196.0;2019;True;37;6.96547619047619
166.0;Barkóczy Gábor;1974;M3;HUN;-;Székesfehérvár;M;219;F3 / 74;6410;6526;6899;19835;6462;0;15953;22415;5599;7485;5177;18261;6768;8338;6351;21457;81968;196.0;2019;True;45;6.970068027210885
167.0;Kaufmann, Bernd;1967;M4;GER;Team Kaufmann;Schramberg;M;504;F4 / 32;5276;6035;7564;18875;6394;0;18005;24399;5143;6380;5399;16922;6247;8283;7213;21743;81939;196.0;2019;True;52;6.967602040816327
168.0;Harrer, Karl;1958;M5;AUT;ÁWF;Sopron;M;324;F5 / 6;5791;0;13752;19543;6055;0;16515;22570;5223;7387;5648;18258;6331;8632;6654;21617;81988;196.0;2019;True;61;6.971768707482993
169.0;Árgyelán Krisztián;1976;M3;HUN;Fősör FC;Kétegyháza;M;322;F3 / 75;5880;0;13745;19625;6752;6747;9120;22619;5198;6944;4759;16901;6710;9229;6960;22899;82044;196.0;2019;True;43;6.976530612244899
51.0;Fejér Zsuzsa;1971;F3;HUN;-;Budapest;F;302;N2 / 35;6459;6785;6761;20005;6456;6492;8994;21942;5533;7364;5197;18094;6667;9046;6488;22201;82242;196.0;2019;True;48;6.993367346938776
170.0;Kovács Endre;1962;M4;HUN;GYÖTRI SC Gyöngyös;Gyöngyös (Mátrafüred);M;260;F4 / 33;6315;0;13864;20179;6384;6648;9709;22741;5270;7167;5436;17873;6343;0;15188;21531;82324;196.0;2019;True;57;7.0003401360544215
171.0;Horváth Norbert;1975;M3;HUN;-;Baja;M;146;F3 / 76;6306;0;13361;19667;6361;6906;10368;23635;5224;7110;5258;17592;6452;8426;6637;21515;82409;196.0;2019;True;44;7.007568027210884
172.0;Sólyom Zoltán;1972;M3;HUN;Ikarus BSE;Budapest;M;261;F3 / 77;5403;5798;6180;17381;6339;6879;10138;23356;5624;7597;5747;18968;7027;8997;6708;22732;82437;196.0;2019;True;47;7.009948979591837
52.0;Kelemen Anett;1987;F2;HUN;-;Pilisvörösvár;F;238;N1 / 9;6144;6386;6712;19242;6394;6763;9315;22472;5403;7452;5520;18375;6741;9070;6740;22551;82640;196.0;2019;True;32;7.0272108843537415
173.0;Schwarzwald, Hans;1963;M4;GER;THOHAN;Erfurt;M;520;F4 / 34;6180;0;14072;20252;6247;6507;10052;22806;5187;7322;5497;18006;6345;8693;6706;21744;82808;196.0;2019;True;56;7.041496598639457
174.0;Petring, Thorsten;1969;M3;GER;-;Erfurt;M;521;F3 / 78;6178;0;14074;20252;6255;6506;10054;22815;5194;7315;5504;18013;6343;0;15397;21740;82820;196.0;2019;True;50;7.04251700680272
175.0;Kis Tamás;1991;M2;HUN;-;Érd;M;198;F1 / 23;6195;6338;6685;19218;6457;6607;9771;22835;5446;7389;5661;18496;6575;8860;6889;22324;82873;196.0;2019;True;28;7.04702380952381
176.0;Recski Ferenc;1980;M2;HUN;-;Békéscsaba;M;262;F2 / 35;5407;5683;7128;18218;5811;8211;9271;23293;4775;7502;5247;17524;6028;10231;7723;23982;83017;196.0;2019;True;39;7.0592687074829925
177.0;Szabó Zoltán Dr.;1958;M5;HUN;-;Dunaújváros;M;162;F5 / 7;6177;6750;7147;20074;6249;6543;9849;22641;5271;7187;5508;17966;6691;8917;6750;22358;83039;196.0;2019;True;61;7.061139455782313
178.0;Bán László;1978;M3;HUN;-;Tázlár;M;202;F3 / 79;5729;5753;7453;18935;6341;0;16809;23150;5299;7321;5468;18088;6464;9026;7385;22875;83048;196.0;2019;True;41;7.061904761904763
179.0;Jeney Gábor;1977;M3;HUN;DSE;Nagymaros;M;294;F3 / 80;5107;5820;6609;17536;6147;6770;10616;23533;5214;7731;5905;18850;6683;9252;7231;23166;83085;196.0;2019;True;42;7.065051020408164
53.0;Kaszás Mária;1972;F3;HUN;Honvéd Sas-hegy SE;Budapest;F;439;N2 / 36;6206;6844;6673;19723;6483;6911;9243;22637;5464;7593;5297;18354;6436;8819;7149;22404;83118;196.0;2019;True;47;7.067857142857143
180.0;Takács Csaba;1973;M3;HUN;Péceli Párducok;Pécel;M;404;F3 / 81;5533;6101;6816;18450;6192;7034;10003;23229;5274;7719;5792;18785;6509;9094;7071;22674;83138;196.0;2019;True;46;7.069557823129252
181.0;Kertész Ádám;1988;M2;HUN;-;Budaörs;M;423;F1 / 24;6689;6722;6902;20313;6684;6874;9132;22690;5559;7610;5292;18461;6517;8676;6737;21930;83394;196.0;2019;True;31;7.091326530612245
182.0;Somogyi Károly;1964;M4;HUN;-;Székesfehérvár;M;144;F4 / 35;5714;0;14296;20010;6306;6779;10296;23381;5265;7403;5312;17980;6526;9349;6184;22059;83430;196.0;2019;True;55;7.094387755102041
183.0;Vass János;1967;M4;HUN;Pénzügyőr SE;Budapest;M;308;F4 / 36;6248;6656;6986;19890;6632;6769;9878;23279;5556;7380;5454;18390;6615;8884;6436;21935;83494;196.0;2019;True;52;7.099829931972788
184.0;Versits Tamás;1969;M3;HUN;-;Budapest;M;133;F3 / 82;5551;5750;6661;17962;5930;7677;8774;22381;5261;0;14044;19305;7226;9613;7016;23855;83503;196.0;2019;True;50;7.100595238095238
54.0;Szabadicsné Madaras Katalin;1967;F3;HUN;-;Zalakaros;F;248;N3 / 8;5974;6837;8316;21127;6553;6643;9628;22824;5467;7460;5352;18279;6532;8678;6360;21570;83800;196.0;2019;True;52;7.125850340136055
185.0;Ivánfi Gábor;1976;M3;HUN;KEFE- Komárom;Komárom;M;334;F3 / 83;5655;0;13239;18894;6476;7021;10285;23782;5187;7353;5170;17710;6957;9959;6773;23689;84075;196.0;2019;True;43;7.149234693877551
186.0;Izsák Tamás;1982;M2;HUN;-;Budapest;M;436;F2 / 36;5369;6466;7258;19093;5823;0;18401;24224;4474;7829;6377;18680;6202;9924;5996;22122;84119;196.0;2019;True;37;7.15297619047619
187.0;Németh-Döltl György;1990;M2;HUN;Pénzügyőr SE;Ócsa;M;288;F1 / 25;6536;6702;7210;20448;6601;6895;9723;23219;5510;7694;5336;18540;6626;9120;6183;21929;84136;196.0;2019;True;29;7.154421768707483
55.0;Máté Mónika;1979;F3;HUN;UFÓ-Utcai Futók Ócsán;Ócsa;F;111;N2 / 37;6536;6699;7216;20451;6608;6892;9320;22820;5526;7687;5461;18674;6640;9292;6263;22195;84140;196.0;2019;True;40;7.154761904761904
188.0;Főző Tibor;1963;M4;HUN;Knorr-Bremse;Budapest;M;327;F4 / 37;6618;6662;7001;20281;6769;7027;9260;23056;5457;7603;5289;18349;6751;0;15723;22474;84160;196.0;2019;True;56;7.156462585034014
189.0;Séra István;1960;M4;HUN;-;Budapest;M;36;F4 / 38;5367;6245;6943;18555;6011;7208;9840;23059;5451;7805;6059;19315;7159;10019;6515;23693;84622;196.0;2019;True;59;7.195748299319727
190.0;Szigeti Attila;1970;M3;HUN;-;Siófok;M;101;F3 / 84;6272;6443;7629;20344;6636;6769;9828;23233;5546;7521;5702;18769;6719;8918;6703;22340;84686;196.0;2019;True;49;7.201190476190477
191.0;Tárnok Balázs;1981;M2;HUN;-;Törökszentmiklós;M;197;F2 / 37;6191;6410;6932;19533;6689;7152;10242;24083;5551;7684;5646;18881;6850;8954;6622;22426;84923;196.0;2019;True;38;7.221343537414967
192.0;Takács István;1967;M4;HUN;-;Gödöllő;M;166;F4 / 39;5841;5955;6618;18414;6283;6875;11458;24616;5397;7688;5734;18819;6917;9213;6959;23089;84938;196.0;2019;True;52;7.222619047619048
56.0;Pintér, Kathrin;1977;F3;GER;FER;Budapest;F;167;N2 / 38;5838;5982;6592;18412;6289;6867;11464;24620;5402;7689;5732;18823;6918;9275;6896;23089;84944;196.0;2019;True;42;7.22312925170068
57.0;Bálits Éva;1966;F3;HUN;-;Diósd;F;401;N3 / 9;6341;6677;6900;19918;6545;6820;9866;23231;5593;7583;5740;18916;6876;9234;7077;23187;85252;196.0;2019;True;53;7.249319727891156
193.0;Matavovszky György;1962;M4;HUN;-;Nyíregyháza;M;448;F4 / 40;6267;6449;6690;19406;6778;6853;9121;22752;5740;7695;5584;19019;7550;9551;7650;24751;85928;196.0;2019;True;57;7.306802721088436
194.0;Rácz László;1977;M3;HUN;Lacko Box SE;Tárnok;M;278;F3 / 85;6019;0;14240;20259;6438;7399;10676;24513;5599;7791;6028;19418;6829;9069;6220;22118;86308;196.0;2019;True;42;7.339115646258503
195.0;Bruntsch, Steffen;1964;M4;GER;LG Mauerweg Berlin e.V.;Berlin;M;529;F4 / 41;6394;7096;7682;21172;6515;7470;10499;24484;5135;7194;5545;17874;6498;9454;6775;22727;86257;196.0;2019;True;55;7.334778911564626
196.0;Szilasy Tibor;1973;M3;HUN;Kistarcsai VSRC;Budapest;M;298;F3 / 86;5490;0;13401;18891;6169;7771;10583;24523;5368;8276;6092;19736;6270;10766;6910;23946;87096;196.0;2019;True;46;7.406122448979591
197.0;Dobó Szilveszter;1974;M3;HUN;-;Domaszék;M;280;F3 / 87;6614;6669;6990;20273;6761;6902;9725;23388;5417;7657;5768;18842;6877;9941;7843;24661;87164;196.0;2019;True;45;7.411904761904762
198.0;Marx Gábor;1976;M3;HUN;-;Győr;M;279;F3 / 88;6351;6813;7523;20687;6685;7087;9806;23578;5553;7908;5595;19056;6695;9469;7797;23961;87282;196.0;2019;True;43;7.421938775510204
199.0;Dzsupin István;1969;M3;HUN;-;Pomáz;M;420;F3 / 89;6388;6969;7745;21102;6567;7027;9976;23570;5643;8017;5774;19434;6934;0;16363;23297;87403;196.0;2019;True;50;7.4322278911564625
200.0;Zab Róbert;1969;M3;HUN;Fuszekli Kaposvár;Kaposvár;M;199;F4 / 42;6253;6692;6975;19920;6484;7269;10360;24113;5458;7776;5933;19167;7269;9988;7370;24627;87827;196.0;2019;True;50;7.46828231292517
201.0;Bajári Attila;1987;M2;HUN;-;Monor;M;149;F1 / 26;6451;7003;7364;20818;6665;7181;9981;23827;5397;8135;6057;19589;6698;9902;7184;23784;88018;196.0;2019;True;32;7.48452380952381
202.0;Demkó Gábor;1973;M3;HUN;Monorierdei Szabadidősport;Monorierdő;M;122;F3 / 90;6453;7003;7365;20821;6673;7183;10309;24165;5402;8130;6063;19595;6675;9905;7182;23762;88343;196.0;2019;True;46;7.512159863945579
203.0;Csecsetka Dániel;1985;M2;HUN;-;Budapest;M;243;F1 / 27;6253;6878;8181;21312;6679;6931;10220;23830;5718;7888;6453;20059;6779;9315;7309;23403;88604;196.0;2019;True;34;7.534353741496599
204.0;Kreszta Zoltán;1970;M3;HUN;-;Budapest;M;11;F3 / 91;5498;5642;7032;18172;6131;7313;10926;24370;5457;7873;6717;20047;0;16871;9557;26428;89017;196.0;2019;True;49;7.569472789115646
205.0;Happ Olivér;1986;M2;HUN;-;Balatonalmádi;M;254;F1 / 28;6037;6359;7071;19467;6468;6854;9918;23240;5351;8176;6206;19733;7920;10959;7758;26637;89077;196.0;2019;True;33;7.574574829931972
206.0;Szegedi Tamás;1974;M3;HUN;-;Veszprém;M;453;F3 / 92;4803;5811;6888;17502;5994;7926;10015;23935;5923;10034;5937;21894;7465;11292;7590;26347;89678;196.0;2019;True;45;7.625680272108844
207.0;Bars Tamás;1983;M2;HUN;-;Budapest;M;320;F2 / 38;6013;0;15360;21373;6602;7013;10874;24489;5868;8073;5964;19905;6867;0;17073;23940;89707;196.0;2019;True;36;7.628146258503401
208.0;Moós Gergely;1978;M3;HUN;DK Team;Budapest;M;246;F3 / 93;6425;0;14813;21238;7393;7492;11193;26078;6126;8874;6551;21551;6998;8449;6709;22156;91023;196.0;2019;True;41;7.740051020408163
209.0;Paraniak, Jan;1950;M5;SWE;Team Sweden;Huddinge;M;569;F5 / 8;6060;6708;7619;20387;6204;7233;11838;25275;5254;8416;7082;20752;6442;11143;8523;26108;92522;196.0;2019;True;69;7.867517006802721
58.0;Nagy Zsuzsanna;1969;F3;HUN;-;Székesfehérvár;F;193;N2 / 39;6359;6871;7854;21084;6759;7132;11405;25296;5729;8262;6740;20731;6943;10410;8092;25445;92556;196.0;2019;True;50;7.870408163265306
210.0;Tóth Iván Csaba;1974;M3;HUN;Fót SE Atlétika;Fót;M;205;F3 / 94;6802;7026;7831;21659;0;14787;10731;25518;6424;9330;5683;21437;7754;0;16246;24000;92614;196.0;2019;True;45;7.8753401360544215
59.0;Nóthof Mónika;1968;F3;HUN;-;Budapest;F;425;N3 / 10;5898;6610;7448;19956;6335;7382;10419;24136;5801;8899;6981;21681;8202;10741;7958;26901;92674;196.0;2019;True;51;7.880442176870748
211.0;Peizer Szabolcs;1971;M3;HUN;BalatoniHajózás;Balatonföldvár;M;417;F3 / 95;6298;6634;8150;21082;6640;7128;11761;25529;5645;8347;6746;20738;0;17373;7968;25341;92690;196.0;2019;True;48;7.881802721088435
212.0;Bakos Gábor;1966;M4;HUN;-;Dunakeszi;M;354;F4 / 43;6025;8162;7463;21650;6633;8254;10440;25327;5736;8674;6244;20654;7461;10692;7237;25390;93021;196.0;2019;True;53;7.909948979591836
213.0;Szanyi Tamás;1978;M3;HUN;-;Gyöngyössolymos;M;141;F3 / 96;6072;6702;7337;20111;6932;7293;10164;24389;5883;9385;6660;21928;7486;11269;7976;26731;93159;196.0;2019;True;41;7.9216836734693885
214.0;Nilsson, Jörgen;1950;M5;SWE;Team Sweden;Hisingkärra;M;566;F5 / 9;6635;6915;8254;21804;6574;6745;11948;25267;5300;8363;7081;20744;6311;11269;8520;26100;93915;196.0;2019;True;69;7.985969387755102
60.0;Prosser Csilla Mrs.;1966;F3;HUN;-;Antau;F;306;N3 / 11;6939;7298;7975;22212;7247;7501;10904;25652;5947;8555;6441;20943;7614;0;17622;25236;94043;196.0;2019;True;53;7.996853741496599
215.0;Czabán László Dr.;1968;M4;HUN;-;Jakabszállás;M;223;F4 / 44;6602;7144;7594;21340;7237;7964;10557;25758;6726;9057;5744;21527;7812;10419;7614;25845;94470;196.0;2019;True;51;8.033163265306122
216.0;Sótér Vilmos Zsolt;1985;M2;HUN;SZAFT Szécsény;Szécsény;M;117;F1 / 29;6603;7138;7932;21673;7066;8134;10550;25750;6730;9056;5741;21527;7809;10395;7634;25838;94788;196.0;2019;True;34;8.060204081632653
217.0;Blücher, Tord;1958;M5;SWE;Team Sweden;Stora;M;565;F5 / 10;6748;7372;7688;21808;7026;8068;10967;26061;6055;9061;6467;21583;7898;10713;7484;26095;95547;196.0;2019;True;61;8.124744897959184
218.0;Ridly István Attila;1981;M2;HUN;Négy Égtáj SE;Nyergesújfalu;M;190;F2 / 39;5979;6777;8625;21381;6795;9465;10692;26952;5739;9581;6568;21888;6868;10351;8507;25726;95947;196.0;2019;True;38;8.15875850340136
999.0;Korcsmáros Tamás;1972;M3;HUN;-;Békéscsaba;M;458;;5761;6348;7209;19318;6714;7528;10367;24609;6365;9032;6519;21916;0;0;0;0;65843;145.0;2019;False;47;7.56816091954023
999.0;Lakatos Roland;1977;M3;HUN;Zalaegerszegi Aszfaltszaggatók;Zalaegerszeg;M;314;;4425;4227;4127;12779;4492;4195;6142;14829;0;0;0;0;0;0;0;0;27608;101.0;2019;False;42;4.555775577557756
999.0;Bencsik Béla;1968;M4;HUN;-;Győrújbarát;M;237;;0;0;0;0;6810;8607;12005;27422;0;0;0;0;7803;10385;8472;26660;54082;104.0;2019;False;51;8.66698717948718
999.0;Kóder Gábor;1981;M2;HUN;Újpalota SC;Dunakeszi;M;255;;5271;5679;6725;17675;0;0;0;0;0;0;0;0;0;0;0;0;17675;48.0;2019;False;38;6.137152777777778
999.0;Erényi Tamás;1970;M3;HUN;GIZIONOK;Budapest;M;171;;6250;6680;9302;22232;0;0;0;0;0;0;0;0;0;0;0;0;22232;48.0;2019;False;49;7.719444444444445
999.0;Dáva Iván;1960;M4;HUN;-;Budapest;M;422;;6050;7366;8800;22216;7431;8640;0;16071;0;0;0;0;0;0;0;0;38287;80.0;2019;False;59;7.976458333333333
999.0;Lundberg, Christian;1981;M2;SWE;-;Saltsjobaden;M;567;;6065;0;14842;20907;0;0;0;0;0;0;0;0;6372;0;14829;21201;42108;99.0;2019;False;38;7.088888888888889
999.0;Feszt István Richárd;1993;M1;HUN;-;Budapest;M;411;;4533;5567;6599;16699;5753;8149;10086;23988;5060;9694;6046;20800;7500;0;0;7500;68987;161.0;2019;False;26;7.141511387163561
999.0;Kakuszi József;1983;M2;HUN;Coffeerun SE;Hódmezővásárhely;M;126;;6274;6333;7420;20027;0;0;0;0;5534;7531;5696;18761;6713;8831;7239;22783;61571;143.0;2019;False;36;7.176107226107226
999.0;Hergovics Gábor;1965;M4;HUN;Honvéd Szondi SE;Székesfehérvár;M;468;;5417;5801;5831;17049;5726;5982;8325;20033;0;0;0;0;0;0;0;0;37082;101.0;2019;False;54;6.1191419141914185
999.0;Hajdu Balázs;1979;M3;HUN;Coffeerun SE;Diósd;M;245;;0;10912;6143;17055;5669;5787;7893;19349;4665;0;0;4665;0;0;0;0;41069;114.0;2019;False;40;6.004239766081872
999.0;Tyberg, Bjoernar;1974;M3;NOR;Smultringgjengen;Aamot;M;515;;5561;5649;5954;17164;5876;6439;9273;21588;5111;0;0;5111;0;0;0;0;43863;114.0;2019;False;45;6.412719298245614
999.0;Czeglédi Csaba;1983;M2;HUN;-;Budapest;M;110;;5162;5353;6318;16833;5527;5502;9010;20039;0;0;0;0;0;0;0;0;36872;101.0;2019;False;36;6.084488448844884
999.0;Pikler Balázs;1976;M3;HUN;-;Kiskorpád;M;464;;5066;5768;7798;18632;5473;0;0;5473;0;0;0;0;0;0;0;0;24105;64.0;2019;False;43;6.27734375
999.0;Földi Mihály;1968;M4;HUN;Alföld TE;Mezőberény;M;225;;4641;5281;5386;15308;0;0;0;0;0;0;0;0;0;0;0;0;15308;48.0;2019;False;51;5.315277777777777
999.0;Lalic, Dragan;1968;M4;AUT;-;Wien;M;511;;6669;0;14226;20895;0;0;0;0;5001;7147;5181;17329;0;0;0;0;38224;92.0;2019;False;51;6.924637681159421
999.0;Szlaukó Róbert;1979;M3;HUN;Süssön Rád a Nap;Budapest;M;118;;0;0;0;0;0;0;0;0;0;0;0;0;0;0;0;0;0;0.0;2019;False;40;
999.0;Szita János;1973;M3;HUN;-;Kaposvár;M;465;;6028;7041;0;13069;6852;0;0;6852;0;0;0;0;0;0;0;0;19921;48.0;2019;False;46;6.917013888888889
999.0;Benya Diana;1981;F2;HUN;-;Budapest;F;274;;5673;0;13067;18740;6164;7843;10927;24934;0;0;0;0;0;0;0;0;43674;101.0;2019;False;38;7.206930693069307
999.0;Koffein Kapitány phd;1979;M3;HUN;-;Szajol;M;277;;6185;0;13732;19917;6530;6976;10270;23776;5563;8180;6397;20140;7203;0;0;7203;71036;161.0;2019;False;40;7.353623188405797
999.0;Schultz, Anke;1968;F3;GER;-;Templin;F;513;;0;0;0;0;0;0;0;0;0;0;0;0;0;0;0;0;0;0.0;2019;False;51;
999.0;Várallyai Károly;1975;M3;HUN;-;Dunakeszi;M;135;;6291;6866;8026;21183;6951;9097;0;16048;6674;8705;6471;21850;7876;10442;7815;26133;85214;175.0;2019;False;44;8.115619047619047
999.0;Korányi Balázs;1974;M3;HUN;-;Frankfurt;M;304;;4996;4994;5078;15068;5050;5057;6940;17047;4216;5688;4483;14387;0;0;0;0;46502;145.0;2019;False;45;5.345057471264368
999.0;Kaufmann, Lea;1995;F1;GER;Team Kaufmann;Schramberg;F;506;;5243;0;16169;21412;0;0;0;0;5364;8703;6999;21066;0;0;0;0;42478;92.0;2019;False;24;7.695289855072464
999.0;Hullán Botond;1970;M3;HUN;-;Budapest;M;350;;5471;6148;7194;18813;5967;6279;9427;21673;0;0;0;0;0;0;0;0;40486;101.0;2019;False;49;6.68085808580858
999.0;Wiesler, Peter;1955;M5;SWE;Team Skavsärer IF;Akersberga;M;568;;0;0;0;0;0;0;0;0;0;0;0;0;7627;0;0;7627;7627;16.0;2019;False;64;7.944791666666666
999.0;Hack Román Antal;1974;M3;HUN;Hack-i mer az nyer;Nyergesújfalu;M;25;;5277;5714;6589;17580;5934;6673;10421;23028;5603;0;0;5603;8507;0;0;8507;54718;131.0;2019;False;45;6.961577608142494
999.0;Marton-Mlecsenkov Éva;1979;F3;HUN;Coffeerun SE;Budapest;F;212;;4906;5096;5632;15634;5341;5408;0;10749;4183;5837;5242;15262;5319;7146;5173;17638;59283;175.0;2019;False;40;5.646
999.0;Garami Csongor;1968;M4;HUN;-;Törökbálint;M;339;;5349;5729;7306;18384;5868;6207;10561;22636;4939;7401;6070;18410;6178;0;0;6178;65608;161.0;2019;False;51;6.791718426501036
999.0;Mihajlo, Jocic;1999;M1;SRB;-;Cantavir;M;331;;6345;7211;8265;21821;6573;8526;10551;25650;6845;0;0;6845;0;0;6351;6351;60667;129.0;2019;False;20;7.838113695090439
999.0;Vass Orsolya;1979;F3;HUN;-;Budapest;F;317;;5197;0;10362;15559;5582;5502;7497;18581;0;0;0;0;5969;0;13580;19549;53689;152.0;2019;False;40;5.886951754385965
999.0;Körmöczy Zoltán;1971;M3;HUN;Dabasi SE;Vecsés;M;297;;5969;6146;6576;18691;6549;7353;8926;22828;0;0;0;0;0;0;0;0;41519;101.0;2019;False;48;6.851320132013202
1.0;Steib Péter;1980;M2;HUN;TFSE;Szigetszentmárton;M;400;F2 / 1;3736;3755;3871;11362;3847;3906;5487;13240;3320;4516;3162;10998;4114;5185;3804;13103;48703;196.0;2018;True;38;4.141411564625851
2.0;Bódis Tamás;1988;M2;HUN;ELTE SE Sashegyi gepárdok;Budapest;M;513;F1 / 1;4017;4082;4165;12264;4183;4007;5862;14052;3405;4430;3193;11028;4105;5196;3737;13038;50382;196.0;2018;True;30;4.284183673469388
3.0;Pintér Tibor;1977;M3;HUN;SUHANJ!;Budapest;M;316;F3 / 1;3738;3880;4323;11941;4105;4258;5841;14204;3384;4609;3436;11429;4239;5818;4404;14461;52035;196.0;2018;True;41;4.424744897959184
4.0;Kopcsányi Zoltán;1977;M3;HUN;Terepfutó SE;Budapest;M;207;F3 / 2;4244;4400;4873;13517;4449;4424;6493;15366;3665;4686;3522;11873;4524;0;10282;14806;55562;196.0;2018;True;41;4.724659863945578
5.0;Tóth Csaba;1973;M3;HUN;HASE;Budapest;M;374;F3 / 3;4244;4398;4653;13295;4454;4415;6649;15518;3669;4790;4017;12476;4527;5828;4694;15049;56338;196.0;2018;True;45;4.7906462585034015
6.0;Kollin Gergely;1972;M3;HUN;Spuri SC;Budapest;M;397;F3 / 4;4499;4558;4708;13765;4752;4637;6413;15802;3910;4952;3492;12354;4595;5974;4558;15127;57048;196.0;2018;True;46;4.851020408163265
7.0;Opitz, Markus;1986;M2;AUT;-;Graz;M;482;F1 / 2;4450;4578;4871;13899;4732;4739;6489;15960;3655;4996;3633;12284;4610;5961;4340;14911;57054;196.0;2018;True;32;4.851530612244898
8.0;Bognár Ákos dr.;1977;M3;HUN;-;Érd;M;260;F3 / 5;4482;4539;4815;13836;4727;4614;6429;15770;3841;4989;3699;12529;5019;6311;4506;15836;57971;196.0;2018;True;41;4.929506802721088
9.0;Bogár János;1964;M4;HUN;Hegyalja 2050;Fancsal;M;396;F4 / 1;3890;4829;4976;13695;4157;4609;6825;15591;3559;5233;3762;12554;4826;6761;4689;16276;58116;196.0;2018;True;54;4.941836734693878
10.0;Kaluz Ákos Bertalan;1981;M2;HUN;Honvéd Szondi SE;Székesfehérvár;M;355;F2 / 2;4322;4553;5029;13904;4644;4699;6907;16250;3761;5044;3848;12653;4821;6145;4529;15495;58302;196.0;2018;True;37;4.95765306122449
11.0;Six, Andreas;1978;M3;AUT;aqotec ultra racing team;Frankenmarkt;M;473;F2 / 3;4409;4787;4869;14065;4600;4625;6518;15743;3765;5152;4053;12970;4900;6139;4708;15747;58525;196.0;2018;True;40;4.976615646258503
1.0;Cseke Lilla;1983;F2;HUN;-;Budapest;F;203;N1 / 1;4369;4515;4702;13586;4503;4684;6705;15892;3853;5395;3907;13155;4699;6392;4895;15986;58619;196.0;2018;True;35;4.984608843537415
12.0;Drexler Zoltán;1975;M3;HUN;Runberries;Budapest;M;114;F3 / 6;4471;4547;4856;13874;4624;4744;6947;16315;3981;5365;3966;13312;4881;6426;4624;15931;59432;196.0;2018;True;43;5.053741496598639
13.0;Pálfi János;1977;M3;HUN;-;Riemst;M;275;F3 / 7;4079;4499;5548;14126;4517;4782;7494;16793;3766;5169;3938;12873;4581;6271;4804;15656;59448;196.0;2018;True;41;5.055102040816326
14.0;Bojtor László Tivadar ifj;1988;M2;HUN;HRSE;Debrecen Pallag;M;357;F1 / 3;4623;4711;4959;14293;4925;4875;6645;16445;3861;5393;4060;13314;4895;6257;4748;15900;59952;196.0;2018;True;30;5.09795918367347
15.0;Dóbé Zsolt;1974;M3;HUN;-;Szeged;M;194;F3 / 8;4495;4592;5010;14097;4856;4973;7481;17310;3984;5424;3933;13341;4879;6187;4499;15565;60313;196.0;2018;True;44;5.128656462585035
2.0;Tóth Éva;1978;F3;HUN;X2S Salomon Team;Telki;F;393;N2 / 1;4593;4769;4851;14213;4789;4762;6852;16403;4119;5621;3977;13717;5062;6684;4736;16482;60815;196.0;2018;True;40;5.171343537414966
16.0;Balogh Róbert;1980;M2;HUN;-;Békéscsaba;M;361;F2 / 4;4782;4930;5004;14716;4890;5001;6991;16882;3996;0;9319;13315;4953;6418;4563;15934;60847;196.0;2018;True;38;5.17406462585034
17.0;Papp Zoltán Levente;1981;M2;HUN;Ironteam SE;Budapest;M;259;F2 / 5;4502;4622;5033;14157;4833;4887;7238;16958;4059;5573;3980;13612;4922;6581;4858;16361;61088;196.0;2018;True;37;5.1945578231292515
18.0;Vanya Sándor;1964;M4;HUN;-;Bonyhád;M;271;F4 / 2;4476;4692;5017;14185;4835;4974;7875;17684;3990;5358;3773;13121;5112;6581;4695;16388;61378;196.0;2018;True;54;5.21921768707483
19.0;Muzhetckii, Nikolai;1960;M4;RUS;-;Sochi;M;483;F4 / 3;4733;4942;4937;14612;4904;4924;6527;16355;4132;5614;3932;13678;5251;6815;5248;17314;61959;196.0;2018;True;58;5.268622448979592
20.0;Lüftenegger, Norbert;1977;M3;AUT;Leimüller Racing Team;Obertrum Am See;M;485;F3 / 9;4407;4847;5424;14678;4902;5078;7363;17343;4209;5450;3910;13569;5131;6659;4821;16611;62201;196.0;2018;True;41;5.289200680272109
3.0;Kelemen Nóra;1972;F3;HUN;B784 Team;Balatonkenese;F;145;N2 / 2;4817;4916;5106;14839;4966;0;11900;16866;4212;5734;4141;14087;5163;6582;4767;16512;62304;196.0;2018;True;46;5.29795918367347
21.0;Nagy Miklós;1968;M3;HUN;Tapolcai Honvéd SE;Sümeg;M;411;F3 / 10;4958;5098;5367;15423;5179;5080;6997;17256;4271;0;9349;13620;5088;6347;4590;16025;62324;196.0;2018;True;50;5.299659863945578
4.0;Sebestyén Tímea;1978;F3;HUN;Egri Városi Sportiskola;Eger;F;358;N2 / 3;4363;4876;5651;14890;4781;4951;7274;17006;4056;5491;4199;13746;4952;6751;5052;16755;62397;196.0;2018;True;40;5.305867346938776
22.0;Kovács Ádám;1973;M3;HUN;-;Budapest;M;372;F3 / 11;4910;5140;5419;15469;5228;5306;7293;17827;4176;5451;3973;13600;4906;6301;4680;15887;62783;196.0;2018;True;45;5.338690476190477
23.0;Bakó Gábor;1968;M3;HUN;Békési DAC;Budakalász;M;205;F4 / 4;4719;5068;5171;14958;4768;5074;7503;17345;4115;5705;4285;14105;5209;6408;4793;16410;62818;196.0;2018;True;50;5.341666666666667
24.0;Korányi Balázs;1974;M3;HUN;-;Budapest;M;232;F3 / 12;4963;0;10197;15160;5071;5072;6817;16960;4219;5622;4005;13846;5433;6953;4848;17234;63200;196.0;2018;True;44;5.374149659863945
25.0;Szalkai Zsolt;1970;M3;HUN;Tapolca Honvéd SE;Tapolca;M;408;F3 / 13;4954;5104;5335;15393;5181;5079;6919;17179;4265;5772;3893;13930;5316;6551;4873;16740;63242;196.0;2018;True;48;5.377721088435374
26.0;Lippai Zoltán;1957;M5;HUN;Anonym SE Bonyhád;Paks;M;381;F5 / 1;4649;4779;4925;14353;4829;4794;7222;16845;4057;5696;4110;13863;5390;7152;5775;18317;63378;196.0;2018;True;61;5.389285714285714
5.0;Herédi-Szabó Krisztina dr.;1978;F3;HUN;-;Szeged;F;134;N2 / 4;5082;5168;5270;15520;5300;5059;7229;17588;4272;5508;4001;13781;5209;6518;4851;16578;63467;196.0;2018;True;40;5.3968537414965985
27.0;Kertész Ervin;1970;M3;HUN;Futóbarátok Egyyesület Győr;Ásványráró;M;178;F3 / 14;4988;5047;5192;15227;5453;5294;7088;17835;4147;0;9679;13826;5277;6404;4939;16620;63508;196.0;2018;True;48;5.400340136054422
28.0;Lódi Tamás;1978;M3;HUN;-;Budapest;M;146;F3 / 15;4831;4816;5393;15040;5385;5300;7512;18197;4296;5616;3948;13860;5021;6605;4870;16496;63593;196.0;2018;True;40;5.407568027210885
29.0;Makai András;1974;M3;HUN;-;Mosonmagyaróvár;M;243;F3 / 16;4830;5009;5327;15166;5035;5100;7157;17292;4149;5496;4250;13895;5165;6779;5425;17369;63722;196.0;2018;True;44;5.418537414965987
30.0;Geréd László Ifj.;1970;M3;HUN;-;Balatonalmádi;M;404;F3 / 17;4998;5212;5284;15494;5311;5185;7242;17738;4271;5618;3869;13758;5257;6647;4913;16817;63807;196.0;2018;True;48;5.425765306122449
31.0;Antal Péter;1968;M3;HUN;-;Budapest;M;149;F3 / 18;4764;4932;5330;15026;4932;5059;7533;17524;4105;5656;4188;13949;5329;6981;5292;17602;64101;196.0;2018;True;50;5.450765306122449
32.0;Bödő Imre;1980;M2;HUN;Honvéd Szondi György SE;Kőszeg;M;407;F2 / 6;4934;5265;5622;15821;4980;5159;7191;17330;4080;5737;4093;13910;5294;0;11946;17240;64301;196.0;2018;True;38;5.467772108843538
33.0;Tigyi László;1960;M4;HUN;SZUFLA;Budapest;M;365;F4 / 5;4490;4728;5183;14401;4993;5151;7341;17485;3970;5571;4103;13644;5615;7685;5714;19014;64544;196.0;2018;True;58;5.48843537414966
34.0;Künstner, Jörn;1970;M3;GER;LG Mauerweg Berlin e.V.;Berlin;M;454;F3 / 19;4928;0;10457;15385;5273;5244;7342;17859;4165;5870;4186;14221;5517;6736;4937;17190;64655;196.0;2018;True;48;5.4978741496598635
35.0;Pikler Balázs;1976;M3;HUN;-;Kiskorpád;M;278;F3 / 20;4781;4983;5414;15178;5033;5116;7519;17668;4222;5911;4417;14550;5094;6948;5254;17296;64692;196.0;2018;True;42;5.501020408163265
36.0;Berei Tibor László;1976;M3;HUN;-;Szigetszentmiklós;M;377;F3 / 21;4384;4734;5294;14412;4851;5116;7971;17938;3893;6057;4715;14665;5048;7103;5539;17690;64705;196.0;2018;True;42;5.5021258503401365
37.0;Hogya Dénes;1981;M2;HUN;Angyalcipők;Budapest;M;191;F2 / 7;4672;4961;5353;14986;5102;5172;7007;17281;4124;5470;4073;13667;4836;6665;7379;18880;64814;196.0;2018;True;37;5.511394557823129
38.0;Takács Gábor;1975;M3;HUN;-;Eger;M;139;F3 / 22;5369;5415;5347;16131;5454;5329;7222;18005;4491;5602;4071;14164;5354;0;11380;16734;65034;196.0;2018;True;43;5.530102040816327
39.0;Hodossy Tamás;1987;M2;SVK;-;Dunajska Streda;M;264;F1 / 4;4848;4948;5120;14916;5606;5509;8081;19196;4302;5670;4127;14099;5413;6774;4771;16958;65169;196.0;2018;True;31;5.541581632653061
6.0;Pap-Csákvári Judit;1970;F3;HUN;-;Tiszaújváros;F;107;N2 / 5;4738;5151;5279;15168;5085;5180;7136;17401;4217;5991;4168;14376;5375;7842;5103;18320;65265;196.0;2018;True;48;5.549744897959184
40.0;Rinat, Rakhmatulin;1973;M3;RUS;SEGMENTONIVEL TEAM;Moscow Region;M;484;F3 / 23;4956;5050;5380;15386;5521;5373;7043;17937;4457;5653;4217;14327;5961;6943;5172;18076;65726;196.0;2018;True;45;5.588945578231293
41.0;Pók János;1963;M4;HUN;Axiál Kft.;Gárdony (Agárd);M;33;F4 / 6;4931;5180;5475;15586;5302;5264;7303;17869;4430;6025;4328;14783;5426;7001;5267;17694;65932;196.0;2018;True;55;5.606462585034013
42.0;Deutschmann Zsolt;1990;M2;HUN;-;Budapest;M;103;F1 / 5;5202;5359;5361;15922;5244;5209;6876;17329;4383;6067;4211;14661;5487;7254;5446;18187;66099;196.0;2018;True;28;5.620663265306123
43.0;Kozma Zsolt;1987;M2;HUN;Esztergomi Futóművek;Tök;M;199;F1 / 6;4643;5008;6537;16188;5204;5501;7481;18186;4210;5998;4322;14530;5268;6989;5143;17400;66304;196.0;2018;True;31;5.638095238095238
44.0;Séra István;1960;M4;HUN;-;Budapest;M;36;F4 / 7;4671;5071;5916;15658;5112;5281;7606;17999;4206;5653;4146;14005;5590;7340;5678;18608;66270;196.0;2018;True;58;5.635204081632653
45.0;Vízer Dániel;1981;M2;HUN;Fehérvári Futótűz SE;Székesfehérvár;M;318;F2 / 8;5191;5374;5606;16171;5480;5431;7535;18446;4419;5740;4162;14321;5502;6798;5193;17493;66431;196.0;2018;True;37;5.648894557823129
46.0;Zsarkó-Berta László;1979;M2;HUN;-;Budapest;M;300;F2 / 9;4887;5238;5515;15640;5238;5356;7510;18104;4327;6101;4683;15111;5637;7167;4874;17678;66533;196.0;2018;True;39;5.657568027210885
47.0;Huszár János;1983;M2;HUN;-;Békéscsaba;M;296;F1 / 7;4976;5100;5557;15633;5223;5454;7694;18371;4296;5875;4416;14587;5408;7210;5469;18087;66678;196.0;2018;True;35;5.669897959183674
48.0;Váradi Zoltán;1973;M3;HUN;-;Érd;M;290;F3 / 24;5562;5526;5623;16711;5663;0;12609;18272;4550;5741;4122;14413;5646;6824;4776;17246;66642;196.0;2018;True;45;5.666836734693878
49.0;Palocsay Géza;1980;M2;HUN;Ferencvárosi Torna Club;Budapest;M;287;F2 / 10;4947;0;10752;15699;5175;5635;8182;18992;4299;5833;4323;14455;5315;7205;5201;17721;66867;196.0;2018;True;38;5.685969387755102
7.0;Kusatz, Patricia;1969;F3;GER;-;Berlin;F;466;N2 / 6;5208;5501;5764;16473;5472;5497;7359;18328;4509;6213;4455;15177;5508;6749;4853;17110;67088;196.0;2018;True;49;5.704761904761905
8.0;Ijjasné Róta Annamária;1981;F2;HUN;-;Békéscsaba;F;242;N2 / 7;4975;5103;5553;15631;5232;5459;7687;18378;4296;5875;4417;14588;5418;7395;5699;18512;67109;196.0;2018;True;37;5.706547619047619
50.0;Salamon István;1962;M4;HUN;-;Mezőtárkány;M;34;F4 / 8;4922;5162;5825;15909;5138;5523;7796;18457;4292;6128;4506;14926;5400;7161;5448;18009;67301;196.0;2018;True;56;5.722874149659864
51.0;Zsíros Ákos;1976;M3;HUN;-;Dunakeszi;M;204;F3 / 25;5318;5456;5735;16509;5482;5420;7408;18310;4483;6038;4265;14786;5553;7010;5016;17579;67184;196.0;2018;True;42;5.7129251700680275
9.0;Farkas Cecilia;1976;F3;HUN;-;Albertirsa;F;288;N2 / 8;5217;5395;5485;16097;5434;5384;7659;18477;4271;5747;4265;14283;5619;7348;5390;18357;67214;196.0;2018;True;42;5.71547619047619
10.0;Balogh Andrea;1970;F3;HUN;EMU;Budapest;F;394;N2 / 9;4958;5447;5668;16073;5452;5652;7516;18620;4340;5957;4312;14609;5402;7242;5338;17982;67284;196.0;2018;True;48;5.7214285714285715
52.0;Horváth Péter;1968;M3;HUN;-;Szombathely;M;386;F3 / 26;5021;5405;5492;15918;5376;5591;7788;18755;4398;5909;4381;14688;5444;7193;5330;17967;67328;196.0;2018;True;50;5.725170068027212
11.0;Csiha Yvette;1980;F2;HUN;-;Budapest;F;127;N2 / 10;5135;5234;5492;15861;5535;5522;7969;19026;4409;5911;4346;14666;5393;7224;5393;18010;67563;196.0;2018;True;38;5.74515306122449
12.0;Katona Éva dr.;1983;F2;HUN;Kancellária SE;Pécs;F;272;N1 / 2;5067;5381;5726;16174;5284;5397;7566;18247;4392;6083;4479;14954;5890;7009;5441;18340;67715;196.0;2018;True;35;5.758078231292517
53.0;Paksi Sándor;1984;M2;HUN;Honvéd Ezüstnyíl;Pápa;M;416;F1 / 8;4871;5137;5446;15454;5316;5533;8057;18906;4585;0;10833;15418;5532;7197;5290;18019;67797;196.0;2018;True;34;5.765051020408164
54.0;Ugróczky Barna;1971;M3;HUN;-;Perenye;M;104;F3 / 27;4884;5189;5522;15595;5308;5486;7682;18476;4567;6298;4490;15355;5702;7417;5464;18583;68009;196.0;2018;True;47;5.783078231292517
55.0;Simon György;1984;M2;HUN;-;Békéscsaba;M;314;F1 / 9;5231;5345;5707;16283;5235;5440;8011;18686;4341;6029;4433;14803;5340;0;12832;18172;67944;196.0;2018;True;34;5.777551020408164
56.0;Fejes Zoltán;1974;M3;HUN;-;Békéscsaba;M;164;F3 / 28;5229;5416;5519;16164;5395;5446;7357;18198;4580;0;10787;15367;5558;7425;5231;18214;67943;196.0;2018;True;44;5.777465986394558
57.0;Major Balázs;1974;M3;HUN;-;Budapest;M;254;F3 / 29;5131;5301;5669;16101;5436;5507;7542;18485;4640;5891;4476;15007;5904;7105;5378;18387;67980;196.0;2018;True;44;5.780612244897959
58.0;Remport Balázs;1983;M2;HUN;Spuri SC;Budapest;M;208;F1 / 10;5320;5607;5965;16892;5508;5461;7467;18436;4543;6032;4431;15006;5644;7045;5165;17854;68188;196.0;2018;True;35;5.798299319727891
59.0;Hugyecz Attila;1969;M3;HUN;Gödi Futóklub;Kosd;M;370;F3 / 30;5059;5446;5839;16344;5650;5597;7630;18877;4513;6034;4300;14847;5621;7318;5183;18122;68190;196.0;2018;True;49;5.798469387755102
60.0;Kollár Zoltán;1965;M4;HUN;Knorr-Bremse;Budapest;M;55;F4 / 9;5136;5538;5888;16562;5579;5636;7616;18831;4637;6139;4379;15155;5527;7064;5103;17694;68242;196.0;2018;True;53;5.802891156462585
61.0;Terpiak, Andrii;1962;M4;UKR;-;Tyachiv;M;256;F4 / 10;5182;5160;5599;15941;5533;5549;7954;19036;4478;6139;4393;15010;5859;7647;5229;18735;68722;196.0;2018;True;56;5.843707482993197
62.0;Kormos Attila dr.;1970;M3;HUN;-;Budapest;M;417;F3 / 31;5441;5426;5647;16514;5605;5509;7579;18693;4595;5941;4397;14933;5767;7609;5304;18680;68820;196.0;2018;True;48;5.8520408163265305
13.0;Hallgató-Csík Ivett;1979;F2;HUN;-;Budapest;F;304;N2 / 11;5232;0;11456;16688;5490;5583;7842;18915;4659;0;10736;15395;5516;0;12414;17930;68928;196.0;2018;True;39;5.8612244897959185
63.0;Láng István;1957;M5;HUN;Gödi Futóklub;Göd (Alsógöd);M;30;F5 / 2;4918;5197;5376;15491;5385;0;13070;18455;4591;6327;4684;15602;5829;7711;5797;19337;68885;196.0;2018;True;61;5.857568027210884
64.0;Czaltig Zsolt;1974;M3;HUN;-;Lajoskomárom;M;150;F3 / 32;5529;5820;5496;16845;5781;5703;7678;19162;4679;6078;4347;15104;5652;7068;5245;17965;69076;196.0;2018;True;44;5.873809523809523
65.0;Barabás Áron;1985;M2;HUN;-;Budapest;M;309;F1 / 11;5173;5348;5583;16104;5582;5595;7574;18751;4771;6433;4438;15642;5779;7615;5273;18667;69164;196.0;2018;True;33;5.881292517006803
14.0;Losonc Tímea;1988;F2;HUN;-;Budapest;F;293;N1 / 3;5107;5187;5730;16024;5109;5235;7635;17979;4341;6391;4863;15595;5431;7694;6448;19573;69171;196.0;2018;True;30;5.88188775510204
66.0;Tóth Bálint;1979;M2;HUN;-;Budapest;M;141;F2 / 11;5277;5677;5832;16786;5860;5821;7762;19443;4470;6288;4670;15428;5303;7195;5058;17556;69213;196.0;2018;True;39;5.885459183673469
15.0;Haffner Kata;1990;F2;HUN;-;Környe;F;160;N1 / 4;4938;5332;6067;16337;5731;5754;8386;19871;4481;5955;4581;15017;5808;7252;5073;18133;69358;196.0;2018;True;28;5.897789115646258
67.0;Szekeres Tibor;1966;M4;HUN;Kadarka Futóegyesület;Szekszárd;M;151;F4 / 11;4929;5466;6344;16739;5257;5436;7793;18486;4348;6175;4834;15357;5635;7517;5763;18915;69497;196.0;2018;True;52;5.909608843537415
68.0;Lóránth Csaba;1971;M3;HUN;-;Nárai;M;253;F3 / 33;5460;5571;5716;16747;5713;5523;7623;18859;4787;6406;4506;15699;5750;7328;5205;18283;69588;196.0;2018;True;47;5.91734693877551
69.0;Tardi László;1977;M3;HUN;-;Kisoroszi;M;261;F3 / 34;5430;5564;5905;16899;5579;5687;7967;19233;4619;6127;4463;15209;5736;7305;5337;18378;69719;196.0;2018;True;41;5.928486394557823
70.0;Dovala, Adrian;1975;M3;SVK;Drnava;Drnava;M;453;F3 / 35;4977;5111;5972;16060;5546;5536;8076;19158;4713;0;10805;15518;5790;7543;5657;18990;69726;196.0;2018;True;43;5.929081632653061
71.0;Lukács Sándor;1975;M3;HUN;-;Bócsa;M;187;F3 / 36;5366;5395;5486;16247;5628;5585;7885;19098;4648;6370;4492;15510;5767;7658;5750;19175;70030;196.0;2018;True;43;5.954931972789116
72.0;Jakab Viktor András;1977;M3;HUN;-;Budapest;M;418;F3 / 37;5321;5637;5903;16861;5614;5596;7945;19155;4479;0;11173;15652;5580;7558;5729;18867;70535;196.0;2018;True;41;5.9978741496598635
73.0;Horváth Tamás;1986;M2;HUN;-;Dombóvár;M;308;F1 / 12;4412;4995;6118;15525;4804;4993;8972;18769;4230;6120;4734;15084;6316;8822;6041;21179;70557;196.0;2018;True;32;5.999744897959184
74.0;Darányi János;1963;M4;HUN;-;Soltvadkert;M;234;F4 / 12;5364;5482;5832;16678;5699;5677;7811;19187;4644;6409;4567;15620;5980;7556;5632;19168;70653;196.0;2018;True;55;6.007908163265306
75.0;Sipos Sándor;1957;M5;HUN;HASE;Budapest;M;367;F5 / 3;5379;5696;5849;16924;5611;5511;7883;19005;4683;6355;4682;15720;5795;7633;5719;19147;70796;196.0;2018;True;61;6.020068027210884
16.0;Sima Éva;1961;F4;HUN;PAFF;Paks;F;375;N3 / 1;5405;5632;5758;16795;5736;5795;7869;19400;4752;6401;4429;15582;6064;7587;5712;19363;71140;196.0;2018;True;57;6.049319727891157
76.0;Vasas Levente;1981;M2;HUN;-;Kecskemét;M;371;F2 / 12;5198;5370;6118;16686;5561;5745;8195;19501;4629;6372;4817;15818;5827;7776;5760;19363;71368;196.0;2018;True;37;6.068707482993197
17.0;Hangya Andrea;1978;F3;HUN;Zebra Futóklub;Budapest;F;171;N2 / 12;5231;5825;6002;17058;5716;5910;7708;19334;4744;6455;4526;15725;5913;0;13375;19288;71405;196.0;2018;True;40;6.071853741496598
77.0;Küllős Máté;1974;M3;HUN;-;Göd (Alsógöd);M;196;F3 / 38;5024;5396;5654;16074;5352;5569;7842;18763;4741;0;11936;16677;5940;8069;5906;19915;71429;196.0;2018;True;44;6.073894557823129
78.0;Sebestyén Ádám Dr.;1973;M3;HUN;-;Budapest;M;108;F3 / 39;5191;5414;5883;16488;5619;5783;8877;20279;4722;0;10688;15410;5844;7765;5767;19376;71553;196.0;2018;True;45;6.084438775510204
79.0;Szocsevka Gábor;1984;M2;HUN;-;Csót;M;415;F1 / 13;4857;5154;5842;15853;5770;0;13632;19402;4724;6528;4915;16167;6209;0;13885;20094;71516;196.0;2018;True;34;6.081292517006803
18.0;Dolmány Fanni;1996;F1;HUN;-;Agárd;F;295;N1 / 5;5775;5893;6161;17829;5919;5799;7796;19514;4833;0;10887;15720;5851;7355;5448;18654;71717;196.0;2018;True;22;6.098384353741497
19.0;Komjáti-Lajkó Mónika;1973;F3;HUN;Tapolcai Honvéd SE;Jánoshalma;F;412;N2 / 13;5389;5612;5837;16838;5547;5755;7840;19142;4778;6547;4707;16032;5894;7899;5932;19725;71737;196.0;2018;True;45;6.100085034013605
80.0;Veres, Sandor;1962;M4;GER;AYCM Racing Team;Chemnitz;M;311;F4 / 13;5213;5506;5663;16382;5836;5682;8166;19684;4920;0;11637;16557;5876;7944;5468;19288;71911;196.0;2018;True;56;6.114880952380952
20.0;Fehérvári Kata;1982;F2;HUN;Runberries;Budapest;F;138;N2 / 14;5307;0;12421;17728;5545;5657;8015;19217;4805;6481;4592;15878;5917;7645;5618;19180;72003;196.0;2018;True;36;6.122704081632653
81.0;Zubor Imre;1973;M3;HUN;-;Budapest;M;162;F3 / 40;5019;5233;5559;15811;5797;6039;8687;20523;4748;0;11583;16331;5934;7766;5725;19425;72090;196.0;2018;True;45;6.130102040816326
82.0;Blaskó Mihály;1980;M2;HUN;Monorierdei Szabadidősport;Monorierdő;M;401;F2 / 13;4707;4964;5965;15636;5470;5844;8067;19381;4711;6752;4898;16361;6151;8347;6318;20816;72194;196.0;2018;True;38;6.138945578231293
83.0;Karlsson, Leif;1963;M4;SWE;Team Sweden;Vastra Frolunda;M;505;F4 / 14;5657;0;12162;17819;5705;5737;8850;20292;4690;0;10385;15075;5783;7703;5541;19027;72213;196.0;2018;True;55;6.140561224489796
84.0;Garancsy Balázs;1972;M3;HUN;Vasemberek Klubja;Budapest;M;201;F3 / 41;5095;0;11706;16801;5853;6161;8261;20275;4809;6564;4446;15819;6027;0;13490;19517;72412;196.0;2018;True;46;6.157482993197278
21.0;Petr Ernestova, Zuzana;1972;F3;CZE;SK Dolar Hajnice;;F;486;N2 / 15;5374;5448;5647;16469;5619;5906;7982;19507;4940;0;11901;16841;6176;7893;5506;19575;72392;196.0;2018;True;46;6.15578231292517
85.0;Simon Zoltán;1970;M3;HUN;-;Solymár;M;37;F3 / 42;5528;5821;6263;17612;5925;6049;7850;19824;4831;6447;4484;15762;6069;7597;5703;19369;72567;196.0;2018;True;48;6.170663265306123
86.0;Navratil István;1961;M4;HUN;Flow SC;Gödöllő;M;289;F4 / 15;5748;6182;6201;18131;5934;5826;7418;19178;4790;6353;4478;15621;6250;7843;5546;19639;72569;196.0;2018;True;57;6.170833333333333
87.0;Major Tibor;1960;M4;HUN;-;Budapest;M;265;F4 / 16;5422;6211;6644;18277;5614;5830;8565;20009;4663;6528;4754;15945;5668;7314;5453;18435;72666;196.0;2018;True;58;6.179081632653061
88.0;Chiba, Masaru;1979;M2;JPN;-;Tokyo;M;481;F2 / 14;5194;5616;6057;16867;5483;5867;8267;19617;4747;6641;4711;16099;6350;7957;5807;20114;72697;196.0;2018;True;39;6.18171768707483
89.0;Venczel Márton;1990;M2;HUN;-;Fót;M;257;F1 / 14;5305;5998;6223;17526;5561;6097;8216;19874;4810;7460;5602;17872;5369;7066;5138;17573;72845;196.0;2018;True;28;6.194302721088435
90.0;Ferenczi Istvan;1977;M3;HUN;Vasas;Solymár;M;301;F3 / 43;5258;5571;6060;16889;6082;0;14249;20331;4892;6692;4981;16565;5992;7761;5415;19168;72953;196.0;2018;True;41;6.203486394557824
91.0;Kóder Gábor;1981;M2;HUN;Újpalota SC;Dunakeszi;M;376;F2 / 15;5300;5303;5493;16096;5770;5818;7893;19481;5194;8977;4675;18846;0;13460;5235;18695;73118;196.0;2018;True;37;6.217517006802722
92.0;Bazsó Tibor;1970;M3;HUN;-;Szombathely;M;182;F3 / 44;5459;5713;6200;17372;5681;5922;8384;19987;4608;6637;4729;15974;5787;8002;6016;19805;73138;196.0;2018;True;48;6.21921768707483
22.0;Hajdu Krisztina Dr.;1971;F3;HUN;-;Szombathely;F;184;N2 / 16;5458;5713;6201;17372;5670;5926;8387;19983;4604;6638;4734;15976;5777;8009;6022;19808;73139;196.0;2018;True;47;6.219302721088435
23.0;Bazsóné Pulai Ibolya;1974;F3;HUN;-;Szombathely;F;313;N2 / 17;5460;5714;6200;17374;5686;5918;8385;19989;4611;6643;4728;15982;5800;8004;6016;19820;73165;196.0;2018;True;44;6.221513605442177
93.0;Karlovitz Máté;1975;M3;HUN;-;Budapest;M;159;F3 / 45;5117;5525;6550;17192;6083;0;14140;20223;5126;7035;4628;16789;6188;7513;5502;19203;73407;196.0;2018;True;43;6.242091836734694
94.0;Szabó Balázs dr.;1970;M3;HUN;Iron Team;Budapest;M;142;F3 / 46;5557;5958;6272;17787;5812;5844;7948;19604;4889;6592;4968;16449;6276;7682;5702;19660;73500;196.0;2018;True;48;6.25
95.0;Kurpé László dr.;1970;M3;HUN;-;Hatvan;M;193;F3 / 47;0;0;17319;17319;5741;5874;8669;20284;4716;6887;4614;16217;5957;8597;5259;19813;73633;196.0;2018;True;48;6.2613095238095235
24.0;Bíró Henrietta;1975;F3;HUN;-;Göd;F;385;N2 / 18;4973;5473;6234;16680;5513;5900;8449;19862;4737;6696;4763;16196;6159;8375;6331;20865;73603;196.0;2018;True;43;6.258758503401361
96.0;Schilt László ifj;1994;M1;HUN;-;Kaposvár-Toponár;M;277;F1 / 15;5017;5240;5920;16177;5683;5678;8210;19571;4905;7322;5587;17814;5832;7837;6423;20092;73654;196.0;2018;True;24;6.263095238095238
97.0;Graser, Werner;1965;M4;AUT;-;Sopron;M;298;F4 / 17;5359;5406;6124;16889;5993;6512;9176;21681;4883;6457;4888;16228;5773;7723;5597;19093;73891;196.0;2018;True;53;6.283248299319728
98.0;Herédi-Szabó Péter;1981;M2;HUN;-;Kecskemét;M;133;F2 / 16;5240;5586;6063;16889;5750;5789;8320;19859;4802;6637;4981;16420;6543;8257;5924;20724;73892;196.0;2018;True;37;6.283333333333333
25.0;Valter Éva;1972;F3;HUN;-;Fót;F;153;N2 / 19;5219;5480;6115;16814;5976;6100;8913;20989;4963;6804;4909;16676;6091;7868;5482;19441;73920;196.0;2018;True;46;6.285714285714286
99.0;Valgut Zoltán;1974;M3;HUN;Kanizsai Futóklub;Nagykanizsa;M;303;F3 / 48;5582;0;11770;17352;5606;5841;8628;20075;4812;0;11096;15908;6571;7956;6149;20676;74011;196.0;2018;True;44;6.293452380952381
100.0;Simon Péter;1965;M4;HUN;-;Budapest;M;368;F4 / 18;4872;5418;6317;16607;5811;5902;8964;20677;4614;6659;5126;16399;5872;8049;6482;20403;74086;196.0;2018;True;53;6.299829931972789
26.0;Milus Ilona Tünde;1973;F3;HUN;Futóbarátok - Nike Futóklub Győr;Győr;F;173;N2 / 20;5478;5772;6048;17298;5874;5926;8511;20311;4973;6937;4917;16827;6136;7677;6109;19922;74358;196.0;2018;True;45;6.322959183673469
101.0;Zömbik László;1961;M4;HUN;Keszthelyi Kilométerek;Keszthely;M;185;F4 / 19;5655;6006;6086;17747;5869;5817;8024;19710;4789;0;11463;16252;6120;8287;6226;20633;74342;196.0;2018;True;57;6.321598639455782
27.0;Bolváry, Martina;1988;F2;GER;Schwimm- und Triathlonverein A.K.I.A. 2009 e.V;Aichach;F;451;N1 / 6;5238;5498;6552;17288;5670;5676;9124;20470;4822;0;11870;16692;6056;0;14205;20261;74711;196.0;2018;True;30;6.352976190476191
28.0;Borg, Victoria;1980;F2;SWE;Team Sweden;Vingaker;F;509;N2 / 21;5001;5203;5357;15561;5101;5721;7843;18665;4546;0;11112;15658;5718;10567;8554;24839;74723;196.0;2018;True;38;6.353996598639457
102.0;Lupan, Anatolie;1984;M2;MDA;-;Chisinau;M;464;F1 / 16;5165;5416;5551;16132;5797;0;14555;20352;4985;0;11964;16949;6131;8256;6997;21384;74817;196.0;2018;True;34;6.361989795918368
103.0;Preil József;1978;M3;HUN;Fehérvári Futótűz SE;Székesfehérvár;M;306;F3 / 49;5289;5464;6605;17358;5832;6014;7923;19769;5041;7823;4732;17596;6414;8049;5893;20356;75079;196.0;2018;True;40;6.384268707482993
104.0;Soós Péter;1970;M3;HUN;Fehérvári Futótűz SE;Székesfehérvár;M;410;F3 / 50;5532;5922;6028;17482;6111;6177;8143;20431;4888;6747;4673;16308;6234;8256;6325;20815;75036;196.0;2018;True;48;6.380612244897959
105.0;Juhász Mihály Dr.;1967;M4;HUN;-;Csongrád;M;283;F4 / 20;4707;4912;5739;15358;5356;5113;7088;17557;5181;8618;5236;19035;6457;8923;8213;23593;75543;196.0;2018;True;51;6.4237244897959185
29.0;Hugyecz Attiláné;1970;F3;HUN;Gödi Futóklub;Kosd;F;369;N2 / 22;5415;0;12062;17477;5831;6263;8399;20493;5030;7158;5136;17324;6091;8255;5973;20319;75613;196.0;2018;True;48;6.4296768707483
106.0;Görtz, Dirk;1967;M4;GER;LC Duisburg & TV 1900 Duisburg Wanheim;Duisburg;M;452;F4 / 21;5616;5818;6059;17493;5676;5889;8740;20305;5073;7157;5233;17463;6126;8419;5969;20514;75775;196.0;2018;True;51;6.443452380952381
107.0;Kotsis Zoltán;1981;M2;HUN;-;Rum;M;269;F2 / 17;5115;5447;6123;16685;5677;5760;8670;20107;5082;7104;5612;17798;6509;0;14684;21193;75783;196.0;2018;True;37;6.444132653061224
30.0;Goebel, Sonia Isabel;1990;F2;GER;LG Mauerweg Berlin e.V.;Berlin;F;455;N1 / 7;6057;0;12701;18758;6438;6013;8383;20834;5095;6774;4912;16781;6046;0;13386;19432;75805;196.0;2018;True;28;6.446003401360545
108.0;Pátkai Attila;1970;M3;HUN;-;Szombathely;M;307;F3 / 51;5810;6057;6349;18216;5984;6110;8422;20516;4958;6772;4926;16656;6142;8274;6080;20496;75884;196.0;2018;True;48;6.452721088435374
109.0;Csepregi Ákos;1983;M2;HUN;-;Keszthely;M;222;F1 / 17;5584;5875;6382;17841;5756;6125;8538;20419;4805;6884;5027;16716;6061;8564;6304;20929;75905;196.0;2018;True;35;6.454506802721088
110.0;Sutyinszky Tamás;1972;M3;HUN;-;Budapest;M;286;F3 / 52;5407;0;11802;17209;5923;6375;8639;20937;4793;6797;5014;16604;6157;0;14988;21145;75895;196.0;2018;True;46;6.453656462585035
111.0;Pálfi László ifj;1977;M3;HUN;Tárnok Sprint Egyesület;Budapest;M;317;F3 / 53;5435;6202;7469;19106;5904;6305;8052;20261;4855;6830;4768;16453;5882;8185;6081;20148;75968;196.0;2018;True;41;6.459863945578232
112.0;Rietkötter, Fritz;1966;M4;GER;Wildeshauser Lauftreff / 100MC;Wildeshausen;M;488;F4 / 22;5526;0;12439;17965;5844;6047;8728;20619;4896;6914;5135;16945;6062;8285;6162;20509;76038;196.0;2018;True;52;6.465816326530612
113.0;Somornai Lajos;1971;M3;HUN;-;Sopron;M;156;F3 / 54;5217;5900;5990;17107;5797;6075;8517;20389;4915;6916;5217;17048;6242;8665;6663;21570;76114;196.0;2018;True;47;6.472278911564626
114.0;Lars-Ake, Johansson;1970;M3;SWE;Team Sweden;Bohus;M;511;F3 / 55;5098;5327;6129;16554;5500;5699;9163;20362;4716;6025;4763;15504;5715;7875;10171;23761;76181;196.0;2018;True;48;6.477976190476191
115.0;Béry Norbert;1970;M3;HUN;-;Söpte;M;118;F3 / 56;5294;5813;6624;17731;5720;5697;9648;21065;4878;7279;5037;17194;5987;8401;5875;20263;76253;196.0;2018;True;48;6.484098639455783
116.0;Csingár István;1976;M3;HUN;Fehérvári Futótűz SE;Székesfehérvár;M;235;F3 / 57;5094;5516;6746;17356;5819;6097;8219;20135;4887;7323;5357;17567;6471;8197;6684;21352;76410;196.0;2018;True;42;6.497448979591836
117.0;Gyenge Péter;1978;M3;HUN;-;Dunakeszi;M;211;F2 / 18;5629;5832;6061;17522;5881;5848;8275;20004;5202;6990;5325;17517;6619;8564;6196;21379;76422;196.0;2018;True;40;6.498469387755102
118.0;Korcsmáros Tamás;1972;M3;HUN;-;Békéscsaba;M;280;F3 / 58;5417;5649;5923;16989;6056;6206;8427;20689;4813;6467;5281;16561;7054;8817;6341;22212;76451;196.0;2018;True;46;6.50093537414966
119.0;Klam Csaba;1970;M3;HUN;-;Soltvadkert;M;29;F3 / 59;5362;5478;6869;17709;5689;5884;8545;20118;4828;6631;4887;16346;6244;8872;7275;22391;76564;196.0;2018;True;48;6.510544217687075
120.0;Molnár Richárd;1965;M4;HUN;Budaörsi DSE;Budaörs;M;373;F4 / 23;4847;5495;6437;16779;5396;5964;8645;20005;4773;7174;5235;17182;6598;0;16090;22688;76654;196.0;2018;True;53;6.518197278911565
121.0;Kjellsson, Tommy;1961;M4;SWE;Team Sweden;Hagersten;M;510;F4 / 24;5476;5891;6209;17576;6030;6333;8862;21225;5031;6953;5125;17109;6165;8308;6301;20774;76684;196.0;2018;True;57;6.520748299319727
122.0;Sümegi Roland;1978;M3;HUN;-;Szécsény;M;122;F2 / 19;5777;6460;6930;19167;5739;5922;8591;20252;4692;6697;5302;16691;6092;8411;6108;20611;76721;196.0;2018;True;40;6.523894557823129
123.0;Szalai Balázs;1974;M3;HUN;Honvéd Szondi György SE;Pápa;M;405;F3 / 60;5325;5754;7055;18134;5840;6441;9802;22083;4786;6790;4904;16480;5964;8193;5952;20109;76806;196.0;2018;True;44;6.531122448979591
124.0;Oberling Ákos;1987;M2;HUN;-;Bokod;M;320;F1 / 18;5444;5637;6450;17531;5786;6145;9049;20980;5022;6905;5283;17210;6416;8403;6444;21263;76984;196.0;2018;True;31;6.5462585034013605
125.0;Tóth István;1978;M3;HUN;-;Budapest;M;116;F2 / 20;4828;5459;7448;17735;5848;5638;8775;20261;4895;6754;5370;17019;6677;8501;6805;21983;76998;196.0;2018;True;40;6.547448979591836
126.0;Hutter Péter;1978;M3;HUN;-;Budapest;M;383;F2 / 21;4853;5656;6836;17345;5507;5682;7763;18952;4731;6967;4618;16316;6920;0;17807;24727;77340;196.0;2018;True;40;6.576530612244898
127.0;Arndt, Alexander;1971;M3;GER;Hüttenberger Land Läufer/TEA;Langgöns;M;456;F3 / 61;5885;6049;6539;18473;6349;6254;8555;21158;5032;6989;5026;17047;6194;8375;6082;20651;77329;196.0;2018;True;47;6.575595238095238
128.0;Kohlfürst, Alois;1955;M5;AUT;-;Eggersdorf;M;489;F5 / 4;5584;5670;6736;17990;5648;6127;9238;21013;4845;7093;5300;17238;6108;8432;6571;21111;77352;196.0;2018;True;63;6.577551020408164
129.0;Mihalik Zoltán;1979;M2;HUN;-;Budapest;M;363;F2 / 22;5317;5463;6050;16830;5875;6376;9005;21256;4986;7339;5411;17736;6364;8722;6527;21613;77435;196.0;2018;True;39;6.584608843537414
130.0;Szigeti Attila;1970;M3;HUN;-;Siófok;M;102;F3 / 62;5987;6225;6265;18477;6374;6316;8760;21450;5129;6824;5049;17002;6378;8072;6128;20578;77507;196.0;2018;True;48;6.590731292517007
131.0;Bakó Attila;1971;M3;HUN;Győri FutOltók;Kunsziget;M;390;F3 / 63;4936;5699;8000;18635;5610;6799;9245;21654;4662;6704;5026;16392;5919;8984;5935;20838;77519;196.0;2018;True;47;6.591751700680272
31.0;Pöltz Hajnalka dr.;1973;F3;HUN;Futóbarátok - Nike Futóklub Győr;Győr;F;188;N2 / 23;5940;6003;6188;18131;6100;6264;8742;21106;5128;7292;4813;17233;6432;8664;6170;21266;77736;196.0;2018;True;45;6.610204081632652
132.0;Péter Mátyás;1986;M2;HUN;-;Budapest;M;181;F1 / 19;5551;5614;5840;17005;5804;5902;8745;20451;5203;7015;5023;17241;7014;9093;7005;23112;77809;196.0;2018;True;32;6.61641156462585
133.0;Horváth Attila;1974;M3;HUN;Futóbarátok - Nike Futóklub Győr;Győr;M;189;F3 / 64;5941;6008;6221;18170;6097;6258;8750;21105;5125;7275;4829;17229;6433;8666;6165;21264;77768;196.0;2018;True;44;6.612925170068028
134.0;Steffen, Sens;1967;M4;GER;LG Mauerweg Berlin;Berlin;M;468;F4 / 25;5101;5721;6921;17743;6640;6402;8459;21501;5293;7107;5265;17665;6364;8345;6216;20925;77834;196.0;2018;True;51;6.618537414965987
135.0;Gelencsér Zoltán;1965;M4;HUN;Tapolca Honvéd SE;Keszthely;M;420;F4 / 26;5827;5752;6116;17695;5982;6416;8652;21050;5101;7192;5085;17378;6774;8357;6647;21778;77901;196.0;2018;True;53;6.6242346938775505
136.0;Bognár Viktor dr.;1971;M3;HUN;Gödi Futóklub;Göd (Alsógöd);M;291;F3 / 65;5357;6060;7077;18494;5905;6407;8800;21112;4981;7016;4975;16972;6473;8628;6252;21353;77931;196.0;2018;True;47;6.626785714285714
137.0;Donkó Antal;1963;M4;HUN;-;Szolnok;M;197;F4 / 27;5412;7108;6542;19062;6004;6465;8888;21357;4941;7022;4954;16917;6248;8436;5971;20655;77991;196.0;2018;True;55;6.63188775510204
32.0;Horváthné Juhász Erika;1971;F3;HUN;-;Szolnok;F;212;N2 / 24;5408;7107;6546;19061;6094;6461;8889;21444;4943;7017;4957;16917;6246;8407;6002;20655;78077;196.0;2018;True;47;6.639200680272109
138.0;Smirnov, Viacheslav;1960;M4;RUS;-;Moscow;M;475;F4 / 28;5535;6169;6991;18695;5899;6282;8989;21170;4943;7162;5141;17246;6152;8629;6153;20934;78045;196.0;2018;True;58;6.636479591836735
139.0;Rudolf József dr.;1970;M3;HUN;-;Budapest;M;111;F3 / 66;5346;5806;6455;17607;5608;6351;8744;20703;4963;6708;5026;16697;6221;9502;7451;23174;78181;196.0;2018;True;48;6.648044217687075
33.0;Terpiak, Halyna;1987;F2;UKR;-;Kyiv;F;255;N1 / 8;5905;6334;6520;18759;6062;6045;8333;20440;5156;7115;5127;17398;6491;8532;6745;21768;78365;196.0;2018;True;31;6.663690476190475
140.0;Szabó Zoltán;1968;M3;HUN;SZVISE Atlétika és Triatlon;Százhalombatta;M;302;F3 / 67;5161;0;12709;17870;5875;6274;8641;20790;4700;7661;5495;17856;6549;9440;6274;22263;78779;196.0;2018;True;50;6.698894557823129
34.0;Petersson, Cecilia;1963;F4;SWE;Team Sweden;Stockholm;F;508;N3 / 2;5770;6172;6371;18313;5964;6098;8767;20829;5163;7082;5311;17556;6615;8973;6690;22278;78976;196.0;2018;True;55;6.715646258503401
141.0;Untila, Alexandr;1989;M2;MDA;-;Chisinau;M;462;F1 / 20;5163;5645;6558;17366;5814;0;14780;20594;5318;7621;5791;18730;7087;0;15741;22828;79518;196.0;2018;True;29;6.761734693877551
35.0;Aranyi Erika dr.;1975;F3;HUN;-;Budapest;F;247;N2 / 25;5503;5948;6425;17876;6274;6387;8812;21473;5018;7502;5262;17782;6561;9014;6829;22404;79535;196.0;2018;True;43;6.763180272108843
142.0;Hack Román Antal;1974;M3;HUN;Hack-i mer az nyer;Nyergesújfalu;M;25;F3 / 68;5827;6067;6808;18702;6119;6617;9812;22548;5115;7168;5380;17663;6166;8679;5900;20745;79658;196.0;2018;True;44;6.773639455782313
143.0;KUNRT, Jaroslav;1975;M3;CZE;SK Dolar Hajnice;;M;487;F3 / 69;5376;6713;8387;20476;5860;6325;8701;20886;4990;7352;5246;17588;6073;8591;6192;20856;79806;196.0;2018;True;43;6.786224489795918
36.0;Pintér, Kathrin;1977;F3;GER;FER;Budapest;F;240;N2 / 26;5946;6172;7032;19150;6479;6476;9384;22339;5268;6870;5156;17294;6489;8979;6018;21486;80269;196.0;2018;True;41;6.825595238095238
144.0;Takács István;1967;M4;HUN;-;Gödöllő;M;241;F4 / 29;6007;6116;7030;19153;6475;6483;9379;22337;5266;6871;5156;17293;6491;8977;6018;21486;80269;196.0;2018;True;51;6.825595238095238
145.0;Vissi Barnabás;1992;M1;HUN;-;Budapest;M;216;F1 / 21;5311;5703;5920;16934;5823;5802;8405;20030;5153;7979;5982;19114;7086;9745;7597;24428;80506;196.0;2018;True;26;6.845748299319728
37.0;Jung Márta;1969;F3;HUN;-;Hőgyész;F;117;N2 / 27;5705;6071;6277;18053;6091;6480;8689;21260;5054;7413;5016;17483;6553;9510;7721;23784;80580;196.0;2018;True;49;6.8520408163265305
146.0;Harrer, Karl;1958;M5;AUT;ÁWF;Sopron;M;299;F4 / 30;5609;6188;6601;18398;5998;6554;9155;21707;5045;7378;5418;17841;6380;9315;6990;22685;80631;196.0;2018;True;60;6.856377551020408
147.0;Fejes László;1973;M3;HUN;-;Budapest;M;230;F3 / 70;5733;6250;6691;18674;6060;6497;9706;22263;5280;0;13528;18808;6318;8496;6307;21121;80866;196.0;2018;True;45;6.876360544217687
148.0;Hattyasy László;1971;M3;HUN;-;Göd (Felsőgöd);M;273;F3 / 71;5671;6346;7203;19220;6224;6363;9128;21715;5170;7344;5259;17773;6683;9072;6432;22187;80895;196.0;2018;True;47;6.878826530612245
149.0;Szőke Zoltán;1972;M3;HUN;-;Tiszavasvári;M;248;F3 / 72;5753;6308;7080;19141;6363;6892;9482;22737;5107;7529;5586;18222;6198;8311;6565;21074;81174;196.0;2018;True;46;6.902551020408164
150.0;Taksonyi Szilárd;1971;M3;HUN;-;Szekszárd;M;402;F3 / 73;5366;5931;6614;17911;6191;6590;9429;22210;4902;7357;5189;17448;6205;10192;7555;23952;81521;196.0;2018;True;47;6.932057823129252
38.0;Hutter-Ternai Mónika;1971;F3;HUN;-;Budapest;F;382;N2 / 28;4926;5663;7803;18392;5837;6344;8177;20358;5244;7625;5399;18268;6851;9903;7978;24732;81750;196.0;2018;True;47;6.951530612244898
151.0;Fülöp Róbert;1971;M3;HUN;Gazella Team;Székesfehérvár;M;144;F3 / 74;5595;6512;7703;19810;6243;6544;9603;22390;5161;0;12736;17897;6277;0;15430;21707;81804;196.0;2018;True;47;6.956122448979592
39.0;Györgyi Katalin;1968;F3;HUN;Fut a Haraszti;Dunaharaszti;F;218;N2 / 29;5706;6628;6964;19298;6438;6773;8949;22160;5268;7551;5304;18123;6875;9095;6427;22397;81978;196.0;2018;True;50;6.970918367346939
152.0;Pozderka Attila;1978;M3;HUN;HASE;Budapest;M;353;F3 / 75;5813;6081;6883;18777;6346;6473;8521;21340;5388;6969;4790;17147;6688;9340;8707;24735;81999;196.0;2018;True;40;6.972704081632654
40.0;Bálits Éva;1966;F3;HUN;-;Diósd;F;360;N3 / 3;6113;6517;7108;19738;6473;6625;8976;22074;5408;7286;5257;17951;6767;9001;6758;22526;82289;196.0;2018;True;52;6.997363945578232
153.0;Körmöczy Zoltán;1971;M3;HUN;Dabasi SE;Vecsés;M;121;F3 / 76;5524;6006;7685;19215;6430;7039;9593;23062;5496;7367;5193;18056;6729;8718;6511;21958;82291;196.0;2018;True;47;6.997534013605442
154.0;Tóth Ferenc dr.;1962;M4;HUN;-;Budapest;M;137;F4 / 31;6053;6739;7064;19856;6359;6292;9181;21832;5228;7617;5435;18280;6593;8759;7100;22452;82420;196.0;2018;True;56;7.008503401360545
155.0;Farkas László;1967;M4;HUN;-;Budapest;M;20;F4 / 32;6000;6431;6878;19309;6574;6726;9383;22683;5519;0;13200;18719;7000;8720;6253;21973;82684;196.0;2018;True;51;7.030952380952381
156.0;Geszti Péter;1986;M2;HUN;-;Budapest;M;399;F1 / 22;6156;6892;6559;19607;6502;6679;9062;22243;5247;7219;5341;17807;6865;9296;6960;23121;82778;196.0;2018;True;32;7.038945578231293
41.0;Nagy Dóra Mária;1988;F2;HUN;-;Budapest;F;167;N1 / 9;5532;6300;6840;18672;6394;6549;9269;22212;5338;7887;5665;18890;6945;9847;6277;23069;82843;196.0;2018;True;30;7.0444727891156464
42.0;Brokat, Helga;1953;F4;GER;LG Mauerweg Berlin;Berlin;F;460;N4 / 1;6278;6815;7344;20437;6772;6592;9061;22425;5464;7350;5542;18356;6853;8739;6041;21633;82851;196.0;2018;True;65;7.0451530612244895
157.0;Gál András;1968;M3;HUN;-;Debrecen;M;270;F3 / 77;5818;6314;7033;19165;6399;6732;9694;22825;5104;7554;5696;18354;6264;9019;7307;22590;82934;196.0;2018;True;50;7.052210884353742
158.0;Veréb Zsolt;1976;M3;HUN;Fut60;Hatvan;M;135;F3 / 78;5901;6954;7469;20324;6362;6954;9390;22706;5292;7613;5212;18117;6663;8561;6567;21791;82938;196.0;2018;True;42;7.052551020408163
43.0;Kovács Nóra dr.;1970;F3;HUN;-;Budapest;F;112;N2 / 30;5836;6448;6693;18977;6356;6697;9405;22458;5366;7813;5493;18672;6385;9150;7643;23178;83285;196.0;2018;True;48;7.082057823129252
44.0;Fejér Zsuzsa;1971;F3;HUN;-;Budapest;F;169;N2 / 31;5919;6020;6113;18052;6282;6620;8846;21748;5425;7995;5689;19109;7312;9822;7367;24501;83410;196.0;2018;True;47;7.092687074829932
159.0;Szabó Zoltán Dr.;1958;M5;HUN;-;Dunaújváros;M;166;F4 / 33;5903;6506;7036;19445;6060;6758;9622;22440;5872;0;13239;19111;6400;8791;7353;22544;83540;196.0;2018;True;60;7.103741496598639
45.0;Pintér Zoltánné;1962;F4;HUN;-;Mezőhegyes;F;292;N3 / 4;6190;6724;6690;19604;6401;7008;8886;22295;5283;7907;5432;18622;6927;9327;6845;23099;83620;196.0;2018;True;56;7.1105442176870755
46.0;Viniczai Andrea;1976;F3;HUN;SUHANJ!;Budapest;F;198;N2 / 32;6001;6426;6880;19307;6580;6722;9386;22688;5524;7576;5621;18721;7139;9246;6850;23235;83951;196.0;2018;True;42;7.138690476190477
160.0;Árgyelán Krisztián;1976;M3;HUN;Fősör FC;Kétegyháza;M;312;F3 / 79;5303;6377;6952;18632;6508;7326;9166;23000;5427;8050;5523;19000;6838;9893;6601;23332;83964;196.0;2018;True;42;7.139795918367348
47.0;Kelemen Anett;1987;F2;HUN;-;Pilisvörösvár;F;154;N1 / 10;5815;6291;7025;19131;6154;6751;9757;22662;5327;7463;5518;18308;6726;9533;7741;24000;84101;196.0;2018;True;31;7.151445578231293
161.0;Csillik Áron;1975;M3;HUN;FER;Budapest;M;210;F3 / 80;6272;7595;6555;20422;6602;6472;9070;22144;5567;7456;5531;18554;6845;9110;6976;22931;84051;196.0;2018;True;43;7.14719387755102
162.0;Feszt István Richárd;1993;M1;HUN;-;Budapest;M;351;F1 / 23;4668;5456;7328;17452;5680;6942;10385;23007;5039;8365;5554;18958;6910;10144;7744;24798;84215;196.0;2018;True;25;7.161139455782313
163.0;Bars Tamás;1983;M2;HUN;-;Budapest;M;231;F2 / 23;5547;6185;7091;18823;6495;6808;9739;23042;5393;7456;5384;18233;7250;9782;7501;24533;84631;196.0;2018;True;35;7.196513605442177
164.0;Ignácz Attila dr.;1969;M3;HUN;-;Miskolc;M;310;F3 / 81;5711;0;14509;20220;6352;6515;9442;22309;5504;8439;5163;19106;6700;9364;6888;22952;84587;196.0;2018;True;49;7.1927721088435375
165.0;Takács Csaba;1973;M3;HUN;Péceli Párducok;Pécel;M;148;F3 / 82;5248;6205;6759;18212;5979;6968;10276;23223;5426;8642;5906;19974;6807;9722;7251;23780;85189;196.0;2018;True;45;7.243962585034013
166.0;Jocic, Mihajlo;1999;M1;SRB;-;Jakodina;M;319;F1 / 24;5924;7128;7786;20838;7394;7487;10550;25431;7180;0;13207;20387;8135;5269;5179;18583;85239;196.0;2018;True;19;7.248214285714286
48.0;Huszák Katalin;1975;F3;HUN;-;;F;190;N2 / 33;5996;6620;7319;19935;6710;6991;9480;23181;5424;7972;5874;19270;6624;9224;7191;23039;85425;196.0;2018;True;43;7.264030612244898
167.0;Hajduk Pavol;1973;M3;SVK;-;Dolný Kubín;M;457;F3 / 83;5696;6385;6938;19019;6419;7169;9840;23428;5574;7503;5666;18743;7628;9511;7176;24315;85505;196.0;2018;True;45;7.270833333333333
168.0;Horváth Zsolt;1977;M3;HUN;-;Balatonalmádi;M;512;F3 / 84;5905;6508;7024;19437;5611;7212;10534;23357;5652;7798;5659;19109;6270;9522;7856;23648;85551;196.0;2018;True;41;7.2747448979591836
169.0;Spivak, Sergii;1985;M2;UKR;-;Kyiv;M;477;F1 / 25;5088;6961;6876;18925;6246;7880;9545;23671;5051;8603;5479;19133;6754;10544;6979;24277;86006;196.0;2018;True;33;7.31343537414966
49.0;Schmitt, Sonja;1975;F3;GER;LG Mauerweg Berlin e.V.;Berlin;F;478;N2 / 34;6275;6823;7341;20439;6816;6839;10194;23849;5460;7351;5542;18353;7143;9350;7078;23571;86212;196.0;2018;True;43;7.330952380952381
170.0;Schmitt, Tom;1961;M4;GER;LG Mauerweg Berlin e.V.;Berlin;M;479;F4 / 34;6277;6819;7347;20443;6822;6833;10204;23859;5451;7355;5546;18352;7138;9189;7239;23566;86220;196.0;2018;True;57;7.331632653061225
171.0;Gnauert, Rene;1972;M3;GER;-;Berlin;M;474;F3 / 85;5999;6425;6885;19309;6580;6813;9865;23258;5524;7652;6031;19207;7147;9743;7577;24467;86241;196.0;2018;True;46;7.333418367346939
172.0;File Tamás;1972;M3;HUN;-;Sajószentpéter;M;124;F3 / 86;5661;6370;7976;20007;6331;6080;10379;22790;5335;8016;5777;19128;7222;9586;7829;24637;86562;196.0;2018;True;46;7.360714285714286
173.0;Sólyom Zoltán;1972;M3;HUN;Ikarus BSE;Budapest;M;281;F3 / 87;5473;5993;6826;18292;5935;7011;10242;23188;5524;0;14475;19999;7671;0;17725;25396;86875;196.0;2018;True;46;7.38732993197279
174.0;Kincse Szabolcs Örs;1973;M3;HUN;-;Budakeszi;M;236;F3 / 88;5994;6423;7158;19575;6442;6964;9932;23338;5530;8410;5487;19427;7125;9717;8139;24981;87321;196.0;2018;True;45;7.425255102040816
175.0;Barák Péter;1974;M3;HUN;-;Érd;M;245;F3 / 89;5581;6873;7882;20336;6771;6974;10140;23885;5616;8208;6041;19865;6770;9315;7487;23572;87658;196.0;2018;True;44;7.453911564625851
176.0;Szlaukó Róbert;1979;M2;HUN;Süssön Rád a Nap;Budapest;M;359;F2 / 24;5350;0;14841;20191;6313;7271;10581;24165;5522;8002;6474;19998;6904;9687;7358;23949;88303;196.0;2018;True;39;7.508758503401361
177.0;Papp Tuma Attila;1965;M4;HUN;MACK;Budapest;M;403;F4 / 35;6355;7117;7807;21279;6842;6976;10237;24055;5608;7762;5731;19101;6988;9429;7420;23837;88272;196.0;2018;True;53;7.506122448979592
178.0;Csecsetka Dániel;1985;M2;HUN;-;Dunakeszi;M;263;F1 / 26;6014;6774;7623;20411;6766;6966;10230;23962;5634;8274;6464;20372;7028;9817;7412;24257;89002;196.0;2018;True;33;7.568197278911564
179.0;Havalda László;1971;M3;HUN;-;Budapest;M;123;F3 / 90;6056;7432;7711;21199;6434;7065;10060;23559;5686;8306;5697;19689;6974;0;17655;24629;89076;196.0;2018;True;47;7.574489795918367
180.0;Weiser, Matthias;1980;M2;GER;LG Mauerweg Berlin e.V.;Berlin;M;469;F2 / 25;6292;6796;7350;20438;6673;6742;10438;23853;5246;7124;5316;17686;8071;10589;8538;27198;89175;196.0;2018;True;38;7.582908163265306
181.0;Péter Ferenc;1971;M3;HUN;-;Szeged;M;282;F3 / 91;5274;6136;7316;18726;6432;7274;10747;24453;5672;8485;6798;20955;7142;10013;7986;25141;89275;196.0;2018;True;47;7.591411564625851
182.0;Iváncsics Zsolt;1968;M3;HUN;EMU;Orosháza;M;419;F4 / 36;6179;6802;7496;20477;6220;6790;11103;24113;5212;8374;6402;19988;6895;10012;8019;24926;89504;196.0;2018;True;50;7.610884353741497
50.0;Hirth Csilla;1975;F3;HUN;-;Bonyhád (Majos);F;101;N2 / 35;5882;6548;7131;19561;6533;7110;10487;24130;5606;8182;6199;19987;7663;10383;8637;26683;90361;196.0;2018;True;43;7.683758503401361
183.0;Kreszta Zoltán;1970;M3;HUN;-;Budapest;M;11;F3 / 92;5471;6215;8557;20243;6760;6973;11800;25533;5593;8046;6724;20363;7017;9562;7705;24284;90423;196.0;2018;True;48;7.689030612244898
184.0;Jeney Gábor;1977;M3;HUN;DSE;Nagymaros;M;176;F3 / 93;5335;6342;7164;18841;6416;7457;10449;24322;5707;9146;6539;21392;7663;11103;8209;26975;91530;196.0;2018;True;41;7.783163265306122
51.0;Gábriel Nikolett;1979;F2;HUN;-;Gárdony (Agárd);F;180;N2 / 36;6004;6622;7439;20065;6426;7456;10445;24327;5715;9134;6547;21396;7671;0;19306;26977;92765;196.0;2018;True;39;7.888180272108843
52.0;Bánfai Beáta;1979;F2;HUN;-;Budapest;F;113;N2 / 37;6022;6968;7454;20444;7126;7725;10486;25337;5668;8728;6438;20834;7884;10695;8272;26851;93466;196.0;2018;True;39;7.947789115646258
185.0;Nilsson, Jörgen;1950;M5;SWE;Team Sweden;Hisingkärra;M;503;F5 / 5;6278;6806;7896;20980;7119;7482;11271;25872;5529;8145;6739;20413;7390;10677;8627;26694;93959;196.0;2018;True;68;7.989710884353742
186.0;Blücher, Tord;1958;M5;SWE;Team Sweden;Stora;M;506;F4 / 37;6416;6841;7820;21077;7113;7479;11288;25880;5831;8700;6285;20816;7604;10456;8623;26683;94456;196.0;2018;True;60;8.031972789115645
187.0;Wikström, Staffan;1955;M5;SWE;Team Sweden;Strömsund;M;507;F5 / 6;6280;6803;7993;21076;7123;7579;11192;25894;5853;8668;6315;20836;7641;10510;8556;26707;94513;196.0;2018;True;63;8.036819727891157
188.0;Nyberg, Hans;1963;M4;SWE;Team Sweden;Nol;M;504;F4 / 38;6510;7336;7558;21404;7156;7486;11233;25875;5957;8542;6275;20774;7595;10540;8563;26698;94751;196.0;2018;True;55;8.057057823129252
189.0;Kloberdanz, René;1973;M3;GER;LG Mauerweg Berlin e.V.;Oranienburg;M;463;F3 / 94;6243;7038;8162;21443;7315;7917;11472;26704;6110;9558;6320;21988;7738;10382;8260;26380;96515;196.0;2018;True;45;8.20705782312925
53.0;Möhr, Andrea;1965;F3;GER;LG Mauerweg Berlin e.V.;Berlin;F;458;N3 / 5;6291;7619;8047;21957;7351;7943;11447;26741;6118;9559;6315;21992;7744;10485;8152;26381;97071;196.0;2018;True;53;8.254336734693878
54.0;Paraniak, Barbro;1956;F4;SWE;Team Sweden;Huddinge;F;502;N4 / 2;6563;7400;8276;22239;7328;7860;11662;26850;6174;8721;6851;21746;7653;10122;8641;26416;97251;196.0;2018;True;62;8.269642857142857
55.0;Pasiciel, Rita;1953;F4;CAN;Mad Hatters Running Club;Medicine Hat;F;472;N4 / 3;6393;7663;8500;22556;7230;7965;11599;26794;6291;9492;6914;22697;7575;10685;8453;26713;98760;196.0;2018;True;65;8.39795918367347
999.0;Rott, Asa;1989;F2;SWE;-;Skövde;F;470;;0;0;0;0;0;0;0;0;0;0;0;0;0;0;0;0;0;0.0;2018;False;29;
999.0;Paraniak, Jan;1950;M5;SWE;Team Sweden;Huddinge;M;501;;5759;6597;7270;19626;0;0;0;0;0;0;0;0;0;0;0;0;19626;49.0;2018;False;68;6.675510204081633
999.0;Károlyi János;1963;M4;HUN;-;Mezőberény;M;237;;4981;5136;5978;16095;5264;5769;8254;19287;4396;5846;4436;14678;0;0;0;0;50060;144.0;2018;False;55;5.793981481481482
999.0;Bihari Nándor;1965;M4;HUN;-;Budapest;M;214;;6172;6812;7579;20563;7025;7510;11489;26024;5660;8618;6772;21050;0;0;0;0;67637;144.0;2018;False;53;7.828356481481482
999.0;Venczel Réka;1990;F2;HUN;-;Budapest;F;258;;5307;5987;6233;17527;5574;6107;8206;19887;4819;7449;5613;17881;0;0;0;0;55295;144.0;2018;False;28;6.3998842592592595
999.0;Szilvási Péter;1986;M2;HUN;Polythlon ETK;Budapest;M;294;;4966;5081;5836;15883;6311;6601;8969;21881;0;0;0;0;0;0;0;0;37764;101.0;2018;False;32;6.231683168316832
999.0;Peyer Zoltán;1980;M2;HUN;Oxygen wellness;Budapest;M;315;;3988;4225;4889;13102;4640;5606;12658;22904;0;0;0;0;0;0;0;0;36006;101.0;2018;False;38;5.941584158415842
999.0;Sótér Vilmos Zsolt;1985;M2;HUN;SZAFT Szécsény;Szécsény;M;213;;0;0;0;0;6565;6911;10153;23629;0;0;0;0;0;0;0;0;23629;50.0;2018;False;33;7.876333333333333
999.0;Mórocza Andrea;1991;F1;HUN;-;Székesfehérvár;F;305;;5063;5496;6799;17358;5552;5893;8326;19771;5005;0;0;5005;0;0;0;0;42134;101.0;2018;False;27;6.952805280528053
999.0;Butkai, Denis;1985;M2;RUS;Vernadka runclub;Vologda;M;467;;4410;4839;5527;14776;4913;5947;8273;19133;0;0;0;0;0;0;0;0;33909;101.0;2018;False;33;5.595544554455445
999.0;Halász Péter;1973;M3;HUN;-;Wien;M;126;;5434;5713;6873;18020;5814;6238;8608;20660;4918;0;0;4918;0;0;0;0;43598;101.0;2018;False;45;7.194389438943895
999.0;Bíró Attila;1978;M3;SVK;-;Dunaszerdahely;M;174;;4791;5001;6364;16156;0;0;0;0;0;0;0;0;0;0;0;0;16156;49.0;2018;False;40;5.495238095238095
999.0;Kovács Katalin dr.;1980;F2;HUN;-;Békéscsaba;F;250;;4980;5073;5196;15249;5265;5276;7693;18234;4618;7205;0;11823;0;0;0;0;45306;101.0;2018;False;38;7.476237623762376
999.0;Hajdú Péter;1954;M5;HUN;Runberries;Budapest;M;125;;5255;5426;6237;16918;6131;6858;10191;23180;5116;7360;5936;18412;0;0;0;0;58510;144.0;2018;False;64;6.7719907407407405
999.0;Garami Csongor;1968;M3;HUN;-;Törökbálint;M;136;;5091;5858;7388;18337;0;0;0;0;5164;0;0;5164;0;0;0;0;23501;65.0;2018;False;50;6.025897435897436
999.0;Litauszki Gyula;1963;M4;HUN;Monorierdő SK;Monorierdő;M;179;;5854;7028;7619;20501;6522;7064;10498;24084;5475;0;0;5475;0;0;0;0;50060;101.0;2018;False;55;8.26072607260726
999.0;Moroné Lázár Zsófia;1972;F3;HUN;FutaPécs SE;Kozármisleny;F;152;;0;0;0;0;0;0;0;0;5780;8546;6790;21116;8377;0;0;8377;29493;65.0;2018;False;46;7.562307692307693
999.0;Tóth Iván Csaba;1974;M3;HUN;Fót SE Atlétika;Fót;M;115;;0;0;0;0;0;0;0;0;0;0;0;0;6772;0;17949;24721;24721;50.0;2018;False;44;8.240333333333332
999.0;Kakuszi József;1983;M2;HUN;Coffeerun SE;Hódmezővásárhely;M;352;;6002;6618;8738;21358;6733;7140;11561;25434;0;0;0;0;0;0;0;0;46792;101.0;2018;False;35;7.7214521452145215
999.0;Bihariné Polgár Erika;1966;F3;HUN;-;Budapest;F;215;;6171;6816;7574;20561;7025;7510;11489;26024;5659;8619;6771;21049;0;0;0;0;67634;144.0;2018;False;52;7.828009259259259
999.0;Gazsi Péter;1986;M2;HUN;-;Budapest;M;195;;5826;6408;7574;19808;6999;0;0;6999;0;0;0;0;0;0;0;0;26807;65.0;2018;False;32;6.873589743589744
999.0;Tóth Ferenc;1972;M3;HUN;Futaújváros;Dunaújváros;M;143;;5944;6894;7876;20714;0;0;0;0;0;0;0;0;0;0;0;0;20714;49.0;2018;False;46;7.0455782312925175
999.0;Rakonczai Adrienn;1975;F3;HUN;-;Budapest;F;209;;0;0;0;0;6600;6466;9075;22141;5569;7462;5529;18560;6848;9106;6980;22934;63635;147.0;2018;False;43;7.21485260770975
999.0;Benkő Pamela;1974;F3;HUN;-;Pécs;F;266;;6402;7857;8898;23157;7508;8457;11141;27106;0;0;0;0;0;0;0;0;50263;101.0;2018;False;44;8.294224422442245
999.0;Ökrös Csaba;1967;M4;HUN;-;Kecskemét;M;140;;5907;6513;7263;19683;6502;7272;10223;23997;0;0;0;0;0;0;0;0;43680;101.0;2018;False;51;7.207920792079208
999.0;Petrik Sándor ifj;1978;M3;HUN;-;Seiersberg;M;471;;5156;5649;6447;17252;6402;6197;8258;20857;4586;6843;5063;16492;0;0;0;0;54601;144.0;2018;False;40;6.3195601851851855
999.0;Balogh Ádám;1979;M2;HUN;BKV Előre SC;Budapest;M;354;;5708;6518;8231;20457;6753;8005;0;14758;6215;0;0;6215;9020;9828;6604;25452;66882;144.0;2018;False;39;7.740972222222222
999.0;Görgényi András;1976;M3;HUN;Békéscsabai Atlétikai Club;Békéscsaba;M;186;;4750;4879;5007;14636;4924;4885;6769;16578;4051;5612;4433;14096;5287;0;0;5287;50597;160.0;2018;False;42;5.270520833333333
999.0;Benya Diana;1981;F2;HUN;-;Budapest;F;252;;5202;6192;6284;17678;0;0;0;0;5062;7176;4448;16686;6852;9596;7931;24379;58743;143.0;2018;False;37;6.846503496503496
999.0;Dzsupin István;1969;M3;HUN;-;Pomáz;M;378;;5960;0;15262;21222;0;0;0;0;0;0;0;0;0;0;0;0;21222;49.0;2018;False;49;7.218367346938775
999.0;Kákai Mónika;1978;F3;HUN;Ultra-atom SE;Dunaszentgyörgy;F;239;;5220;5380;5627;16227;5575;5597;7733;18905;0;0;0;0;0;0;0;0;35132;101.0;2018;False;40;5.797359735973597
999.0;Süle Krisztián Péter;1974;M3;HUN;-----------------;Budapest;M;130;;5903;6298;6671;18872;5983;6457;9823;22263;5384;0;0;5384;0;0;0;0;46519;101.0;2018;False;44;7.676402640264027
999.0;Hergovits Gábor;1965;M4;HUN;Honvéd Szondi SE;Székesfehérvár;M;406;;4920;5193;5587;15700;5463;5673;7633;18769;0;0;0;0;0;0;0;0;34469;101.0;2018;False;53;5.6879537953795385
1.0;Steib Péter;1980;M2;HUN;TFSE;Szigetszentmárton;M;356;F1/1;3951;3960;3979;11890;4095;4084;5518;13697;3603;4344;2845;10792;4156;5600;3761;13517;49896;193.0;2017;True;37;4.30880829015544
2.0;Peyer Zoltán;1980;M2;HUN;Oxygen wellness;Budapest;M;369;F1/2;0;8008;4379;12387;4300;0;10007;14307;3586;4526;3008;11120;4147;5457;3806;13410;51224;193.0;2017;True;37;4.423488773747841
3.0;Csécsei Zoltán;1984;M2;HUN;Szufla SE;Marcali;M;346;F1/3;3997;4093;4264;12354;4305;0;9859;14164;3591;4490;3054;11135;4149;6109;4940;15198;52851;193.0;2017;True;33;4.563989637305699
4.0;Reichsmann Gábor;1975;M3;HUN;-;Őrbottyán;M;280;F2/1;4102;4386;4843;13331;4416;4475;6237;15128;3772;4641;3212;11625;4030;0;10033;14063;54147;193.0;2017;True;42;4.675906735751296
5.0;Kaluz Ákos Bertalan;1981;M2;HUN;Honvéd Szondi SE;Székesfehérvár;M;363;F1/4;4455;4545;4898;13898;4367;4398;6267;15032;3768;4527;3157;11452;3985;0;10154;14139;54521;193.0;2017;True;36;4.7082037996545765
6.0;Rumm, Harald;1975;M3;GER;Ultra Team Hohenlohe;Mulfingen;M;470;F2/2;4807;4739;4601;14147;4699;4579;6152;15430;3910;4791;3130;11831;4033;5648;4099;13780;55188;193.0;2017;True;42;4.7658031088082895
7.0;Toldi Péter;1981;M2;HUN;-;Szeged;M;197;F1/5;4576;4720;4800;14096;4743;4640;6195;15578;4136;4858;3127;12121;4303;5848;3963;14114;55909;193.0;2017;True;36;4.828065630397237
8.0;Kollin Gergely;1972;M3;HUN;Spuri SC;Budapest;M;307;F2/3;4572;4719;4715;14006;4669;4657;6427;15753;4183;4826;3152;12161;4171;5879;4187;14237;56157;193.0;2017;True;45;4.849481865284974
9.0;Bognár Ákos dr.;1977;M3;HUN;-;Érd;M;286;F1/6;4676;4737;4731;14144;4717;4632;6376;15725;3965;4929;3211;12105;4368;6077;4396;14841;56815;193.0;2017;True;40;4.906303972366148
10.0;Havasi György;1973;M3;HUN;Hírös Pockok HSE;Kecskemét;M;359;F2/4;4470;4628;4946;14044;4714;4617;6644;15975;4065;5030;3322;12417;4302;6031;4461;14794;57230;193.0;2017;True;44;4.942141623488774
1.0;Molnár Gitta;1983;F2;HUN;-;Békéscsaba;F;337;N1/1;4556;4661;4990;14207;4688;4719;6459;15866;4046;5070;3312;12428;4390;6130;4558;15078;57579;193.0;2017;True;34;4.9722797927461135
11.0;Vaczkó Zsolt;1971;M3;HUN;Ironteam SE;Budapest;M;296;F2/5;4498;0;9078;13576;4517;0;11510;16027;0;0;12242;12242;4397;6781;4874;16052;57897;193.0;2017;True;46;4.999740932642487
12.0;Tóth Csaba;1973;M3;HUN;HASE;Budapest;M;306;F2/6;4116;4437;5468;14021;4572;4845;6951;16368;4013;5069;3250;12332;4360;6098;4727;15185;57906;193.0;2017;True;44;5.000518134715026
2.0;Kovács Éva Dr.;1986;F2;HUN;SUHANJ!;Budapest;F;352;N1/2;4315;4855;5260;14430;4702;4748;6565;16015;4048;5076;3435;12559;4388;0;10949;15337;58341;193.0;2017;True;31;5.038082901554405
13.0;Pálfi János;1977;M3;HUN;-;Waterloo;M;238;F2/7;3996;4286;5593;13875;4338;0;12812;17150;0;8737;3475;12212;4111;6212;5272;15595;58832;193.0;2017;True;40;5.08048359240069
14.0;Medgyessy Gergely;1970;M3;HUN;-;Budapest;M;343;F2/8;4701;4875;5774;15350;4792;4750;6495;16037;4150;5349;3661;13160;4348;5885;4330;14563;59110;193.0;2017;True;47;5.104490500863558
15.0;Lippai Zoltán;1957;M5;HUN;Anonym SE Bonyhád;Paks;M;236;F3/1;4742;4893;5170;14805;4907;4833;6878;16618;4190;4988;3227;12405;4496;6256;4653;15405;59233;193.0;2017;True;60;5.115112262521589
16.0;Schulze, Andreas;1960;M4;GER;ASFM Göttingen;Göttingen;M;465;F3/2;4908;5028;5064;15000;4949;4809;6626;16384;4162;5076;3425;12663;4491;6197;4526;15214;59261;193.0;2017;True;57;5.1175302245250425
17.0;Balogh Róbert;1980;M2;HUN;-;Békéscsaba;M;304;F1/7;4889;4965;5085;14939;5040;5084;6629;16753;0;9482;3198;12680;4398;6403;4546;15347;59719;193.0;2017;True;37;5.157081174438687
18.0;Tigyi László;1960;M4;HUN;SZUFLA;Budapest;M;305;F3/3;4745;4688;5025;14458;4679;4765;6694;16138;4010;5252;3490;12752;4516;6953;5230;16699;60047;193.0;2017;True;57;5.185405872193437
19.0;Kozma Zsolt;1987;M2;HUN;Esztergomi Futóművek;Tök;M;109;F1/8;4313;4859;5838;15010;4684;4753;7009;16446;4118;5342;3663;13123;4542;6418;4733;15693;60272;193.0;2017;True;30;5.204835924006908
20.0;Bíró, Attila;1978;M2;SVK;-;Dunaszerdahely;M;165;F1/9;4725;4841;5261;14827;5068;5029;6753;16850;4364;5271;3374;13009;4475;6482;4731;15688;60374;193.0;2017;True;39;5.213644214162349
21.0;Görgényi András;1976;M3;HUN;-;Békéscsaba;M;168;F2/9;4888;4949;5256;15093;5100;4887;6773;16760;4266;5219;3484;12969;4508;6424;4721;15653;60475;193.0;2017;True;41;5.222366148531951
22.0;Kőrösi Koppány dr.;1971;M3;HUN;Kilóméter gyüjtők;Budapest;M;189;F2/10;4470;4632;5263;14365;4581;4832;7301;16714;4194;5372;3622;13188;4579;6544;5167;16290;60557;193.0;2017;True;46;5.229447322970639
23.0;Bíró Géza;1967;M3;HUN;-;Balatonkeresztúr;M;355;F2/11;4697;4832;4919;14448;4893;4803;6836;16532;4348;5405;3492;13245;4708;6756;5164;16628;60853;193.0;2017;True;50;5.255008635578584
3.0;Simon Edina;1971;F3;HUN;Salgótarjáni Atlétikai Club;Szücsi;F;279;N2/1;5035;0;10201;15236;4969;4880;6929;16778;4227;5425;3448;13100;4511;6479;4827;15817;60931;193.0;2017;True;46;5.261744386873921
24.0;Papp Sándor;1970;M3;HUN;Debreceni Rendőr SE;Vámospércs;M;235;F2/12;4583;4873;5566;15022;5064;5113;7352;17529;4229;5303;3463;12995;4539;6313;4649;15501;61047;193.0;2017;True;47;5.271761658031088
25.0;Hogya Dénes;1981;M2;HUN;Angyalcipők;Budapest;M;166;F1/10;4999;5125;5702;15826;5060;5059;6763;16882;4303;5373;3376;13052;4386;6378;4508;15272;61032;193.0;2017;True;36;5.270466321243523
26.0;Drexler Zoltán;1975;M3;HUN;Runberries;Budapest;M;302;F2/13;4976;5081;5216;15273;5119;5093;6805;17017;4261;5334;3548;13143;4479;6379;4777;15635;61068;193.0;2017;True;42;5.273575129533678
4.0;Szilágyi Szvetlana;1976;F3;HUN;Békési DAC;Békéscsaba;F;350;N2/2;4967;5127;5192;15286;5172;5029;6802;17003;4508;0;9109;13617;4522;6348;4592;15462;61368;193.0;2017;True;41;5.299481865284974
27.0;Dóbé Zsolt;1974;M3;HUN;-;Szeged;M;214;F2/14;4059;4481;5597;14137;4644;5221;8439;18304;4126;5391;3692;13209;4550;6613;4755;15918;61568;193.0;2017;True;43;5.316753022452505
28.0;Vanya Sándor;1964;M4;HUN;-;Bonyhád;M;239;F3/4;4806;4945;5166;14917;5129;5140;7198;17467;4242;5403;3444;13089;4627;6726;4842;16195;61668;193.0;2017;True;53;5.325388601036269
29.0;Jász Máté dr.;1973;M3;HUN;-;Budapest;M;244;F2/15;4994;5177;5505;15676;5162;5065;6932;17159;4301;5302;3549;13152;4611;6517;4587;15715;61702;193.0;2017;True;44;5.328324697754749
30.0;Séra István;1960;M4;HUN;Futóbolondok SE;Budapest;M;370;F3/5;4645;4905;5444;14994;4938;5350;7180;17468;4230;5426;3516;13172;4606;6630;4876;16112;61746;193.0;2017;True;57;5.332124352331606
31.0;Borbás Tibor Szabolcs;1982;M2;HUN;-;Táplánszentkereszt;M;160;F1/11;4758;4942;5276;14976;5047;5098;6900;17045;4347;5489;3642;13478;4589;6599;5079;16267;61766;193.0;2017;True;35;5.333851468048359
32.0;Kovács Ádám;1973;M3;HUN;-;Budapest;M;269;F2/16;4538;4791;5558;14887;4890;5155;7121;17166;4360;5462;3586;13408;4537;6765;5007;16309;61770;193.0;2017;True;44;5.33419689119171
5.0;Sebestyén Tímea;1978;F2;HUN;Honvéd Szondi György SE;Eger;F;366;N2/3;5032;5846;5587;16465;5132;5112;6932;17176;4003;5148;3593;12744;4237;6327;4871;15435;61820;193.0;2017;True;39;5.338514680483592
33.0;Elford, Nick;1976;M3;GBR;Robert Elford Fitness;Woking;M;468;F2/17;4502;4600;5201;14303;4829;4828;7838;17495;4180;5360;3784;13324;4599;7076;5883;17558;62680;193.0;2017;True;41;5.412780656303973
6.0;Bosznay Diána;1976;F3;HUN;Csömöri Sport Kft.;Csömör;F;320;N2/4;4856;4996;5088;14940;4955;5053;7537;17545;4167;5358;3662;13187;4597;7781;5609;17987;63659;193.0;2017;True;41;5.497322970639033
7.0;Pap-Csákvári Judit;1970;F3;HUN;-;Tiszaújváros;F;118;N2/5;5049;5325;5602;15976;5350;0;12364;17714;4644;5541;3512;13697;4831;6726;4708;16265;63652;193.0;2017;True;47;5.496718480138169
34.0;Csalló Gergő;1981;M2;HUN;-;Veszprém;M;131;F1/12;4765;5034;5616;15415;5163;5171;7591;17925;4429;5621;3773;13823;4743;6748;5054;16545;63708;193.0;2017;True;36;5.501554404145078
35.0;Blaskó Mihály;1980;M2;HUN;-;Monorierdő;M;294;F1/13;4591;4816;5392;14799;5097;5377;7199;17673;4313;5609;3706;13628;4939;7363;5333;17635;63735;193.0;2017;True;37;5.503886010362694
36.0;Hoskó Roland;1976;M3;HUN;-;Budapest;M;148;F2/18;5083;5222;5664;15969;5271;5150;7627;18048;4450;0;9169;13619;4652;0;11571;16223;63859;193.0;2017;True;41;5.514594127806562
37.0;Taksonyi Szilárd;1971;M3;HUN;-;Szekszárd;M;264;F2/19;4514;4935;5518;14967;5169;5169;6851;17189;4371;0;9066;13437;5035;8009;5611;18655;64248;193.0;2017;True;46;5.548186528497409
38.0;Györfi János;1983;M2;HUN;-;Budapest;M;340;F1/14;4825;4999;5471;15295;4834;5223;7636;17693;4317;5867;3935;14119;4729;7205;5411;17345;64452;193.0;2017;True;34;5.56580310880829
8.0;Martinák Anikó;1973;F3;HUN;-;Budapest;F;339;N2/6;5073;5214;5106;15393;5219;5268;7334;17821;4598;6026;3860;14484;0;11921;5003;16924;64622;193.0;2017;True;44;5.58048359240069
39.0;Szalkai Zsolt;1974;M3;HUN;Tapolca Honvéd SE;Tapolca;M;360;F2/20;5185;5360;5758;16303;5429;5302;7194;17925;4743;5801;3670;14214;5051;7027;4805;16883;65325;193.0;2017;True;43;5.641191709844559
40.0;Kiss Sándor;1965;M4;HUN;-;Görcsöny;M;354;F3/6;5037;5170;5766;15973;5124;5146;7202;17472;4462;5952;4179;14593;4710;0;12484;17194;65232;193.0;2017;True;52;5.633160621761658
41.0;Biros Zalán;1975;M3;HUN;-;Budapest;M;347;F2/21;4316;4852;6607;15775;5157;5504;9609;20270;4560;5599;3452;13611;4700;0;10898;15598;65254;193.0;2017;True;42;5.635060449050086
42.0;Pantis, Mihai Vlad;1983;M2;ROM;RO CLUB MARATON;Cluj-Napoca;M;457;F1/15;5198;5592;5850;16640;5209;5304;7407;17920;4682;5461;3513;13656;5023;7044;5027;17094;65310;193.0;2017;True;34;5.639896373056994
43.0;Takács Gábor;1975;M3;HUN;-;Eger;M;211;F2/22;5382;5413;5510;16305;5456;5341;7137;17934;4720;0;9398;14118;5059;6875;5015;16949;65306;193.0;2017;True;42;5.6395509499136445
44.0;Györe Márk;1978;M2;HUN;-;Budapest;M;256;F1/16;5269;5491;5427;16187;5466;5294;7280;18040;4654;0;9470;14124;5071;6963;4968;17002;65353;193.0;2017;True;39;5.643609671848014
45.0;Szabó Péter;1980;M2;HUN;-;Budapest;M;129;F1/17;5039;5247;5616;15902;5254;5317;7063;17634;4538;5659;3804;14001;5100;7400;5527;18027;65564;193.0;2017;True;37;5.661830742659759
46.0;Acsádi Lajos;1972;M3;HUN;-;Nádudvar;M;101;F2/23;5106;5136;5556;15798;5248;5330;7064;17642;4843;5958;4012;14813;4992;7255;5327;17574;65827;193.0;2017;True;45;5.68454231433506
47.0;Pivnyik László;1976;M3;HUN;-;Nyíregyháza;M;106;F2/24;5172;5435;5406;16013;5302;5257;7559;18118;4274;5626;3954;13854;4681;7359;6052;18092;66077;193.0;2017;True;41;5.706131260794473
48.0;Navratil István;1961;M4;HUN;Flow SC;Gödöllő;M;250;F3/7;5724;6202;5704;17630;5418;5463;6880;17761;4773;5978;3479;14230;4796;6787;4901;16484;66105;193.0;2017;True;56;5.708549222797927
49.0;Kertész Ervin;1970;M3;HUN;Futóbarátok Egyyesület Győr;Ásványráró;M;217;F2/25;5017;5397;5555;15969;5690;5484;7920;19094;4192;5359;3985;13536;4974;7221;5367;17562;66161;193.0;2017;True;47;5.7133851468048364
50.0;Kotsis Zoltán;1981;M2;HUN;-;Rum;M;164;F1/18;5073;0;10819;15892;5260;0;12861;18121;4597;5858;3903;14358;5054;7412;5425;17891;66262;193.0;2017;True;36;5.722107081174438
51.0;Makai András;1974;M3;HUN;-;Mosonmagyaróvár;M;163;F2/26;5320;5373;5950;16643;5394;5534;7406;18334;4742;5881;3824;14447;5187;7127;4778;17092;66516;193.0;2017;True;43;5.7440414507772015
52.0;Reifenberger, Frank;1961;M4;GER;SSC Hanau-Rodenbach;Hanau;M;475;F3/8;5300;0;11469;16769;5552;5447;7193;18192;4756;5742;3714;14212;5054;7096;5183;17333;66506;193.0;2017;True;56;5.743177892918826
53.0;Huszty Béla;1964;M4;HUN;Kalocsai Földön Futók;Kalocsa;M;190;F3/9;5191;0;10916;16107;5487;0;13253;18740;4703;5947;3806;14456;4953;7299;5039;17291;66594;193.0;2017;True;53;5.750777202072539
54.0;Darányi János;1963;M4;HUN;-;Soltvadkert;M;146;F3/10;5386;0;11175;16561;5470;5544;7427;18441;4456;5717;3790;13963;5177;7252;5227;17656;66621;193.0;2017;True;54;5.753108808290155
55.0;Bakó Gábor;1968;M3;HUN;Békési DAC;Budakalász;M;219;F2/27;5590;0;10988;16578;5149;5631;8146;18926;4386;5650;4102;14138;4760;7094;5147;17001;66643;193.0;2017;True;49;5.755008635578584
56.0;Geréd László Ifj.;1970;M3;HUN;-;Balatonalmádi;M;357;F2/28;5372;5369;6036;16777;5429;5335;7556;18320;4751;5949;3711;14411;4966;7129;5050;17145;66653;193.0;2017;True;47;5.755872193436961
57.0;Papp Zoltán Levente;1981;M2;HUN;Ironteam SE;Budapest;M;212;F1/19;5393;5528;5757;16678;5538;0;12873;18411;4760;5822;3826;14408;4976;7003;5204;17183;66680;193.0;2017;True;36;5.758203799654576
58.0;Preil József;1978;M2;HUN;-;Székesfehérvár;M;345;F1/20;5366;5568;5655;16589;5630;5653;7490;18773;4736;5795;3613;14144;5003;6931;5328;17262;66768;193.0;2017;True;39;5.7658031088082895
59.0;Ugróczky Barna;1971;M3;HUN;-;Perenye;M;104;F2/29;5420;0;11376;16796;5627;5590;7414;18631;4868;5893;3596;14357;5093;6936;5118;17147;66931;193.0;2017;True;46;5.7798791018998275
60.0;Terpiak, Andrii;1962;M4;UKR;-;Tyachiv;M;155;F3/11;4578;4828;5909;15315;5326;5597;7555;18478;4517;5764;4300;14581;5388;7688;5675;18751;67125;193.0;2017;True;55;5.796632124352332
61.0;Szekeres Tibor;1966;M4;HUN;Kadarka Futóegyesület;Szekszárd;M;134;F3/12;5141;5927;6836;17904;5466;5432;7760;18658;4460;0;9502;13962;4839;6841;4978;16658;67182;193.0;2017;True;51;5.801554404145078
9.0;Barna Anikó;1987;F2;HUN;-;Bagnolet;F;184;N1/3;5053;5389;5963;16405;5486;5404;7559;18449;4639;5948;3932;14519;4979;7150;5776;17905;67278;193.0;2017;True;30;5.809844559585492
62.0;Kormos Attila dr.;1970;M3;HUN;-;Budapest;M;367;F2/30;5531;5656;5669;16856;5552;0;13179;18731;4735;5753;3822;14310;5090;7182;5145;17417;67314;193.0;2017;True;47;5.812953367875648
10.0;Csapó Judit;1973;F3;HUN;Teljesítménytúrázók Társasága;Osztopán;F;344;N2/7;4770;0;11385;16155;5298;5738;7684;18720;4616;6028;3875;14519;5085;7419;5460;17964;67358;193.0;2017;True;44;5.816753022452505
63.0;Vízer Dániel;1981;M2;HUN;Fehérvári Futótűz SE;Székesfehérvár;M;193;F1/21;5471;5607;5972;17050;5580;5530;7458;18568;4761;0;9463;14224;5106;7097;5369;17572;67414;193.0;2017;True;36;5.821588946459412
11.0;Bálint Éva;1972;F3;HUN;-;Budapest;F;322;N2/8;5340;5357;5943;16640;5397;5533;7621;18551;4748;5865;3841;14454;5190;7379;5548;18117;67762;193.0;2017;True;45;5.851640759930915
64.0;Lars-Ake, Johansson;1970;M3;SWE;Team Marathonguidema;Bohus;M;511;F2/31;5423;5574;5991;16988;5306;5588;8062;18956;4493;5791;4039;14323;4699;7213;5784;17696;67963;193.0;2017;True;47;5.8689982728842836
65.0;Láng István;1957;M5;HUN;Gödi Futóklub;Göd (Alsógöd);M;30;F3/13;4749;4960;5962;15671;5381;5525;8491;19397;4596;5856;3848;14300;5076;0;13511;18587;67955;193.0;2017;True;60;5.868307426597582
66.0;Major Balázs;1974;M3;HUN;-;Budapest;M;173;F2/32;5424;0;11627;17051;5716;0;13327;19043;4812;0;9611;14423;5091;7089;5376;17556;68073;193.0;2017;True;43;5.878497409326425
67.0;Czaltig Zsolt;1974;M3;HUN;-;Lajoskomárom;M;123;F2/33;5681;5896;5960;17537;5409;5476;7435;18320;4630;5739;3884;14253;5143;7539;5565;18247;68357;193.0;2017;True;43;5.903022452504318
12.0;Marton-Mlecsenkov Éva;1979;F2;HUN;Élményfutárok;Budapest;F;216;N2/9;5110;5446;6568;17124;5546;6012;7956;19514;4590;5983;4173;14746;5050;6847;5241;17138;68522;193.0;2017;True;38;5.91727115716753
13.0;Komjáti-Lajkó Mónika;1973;F3;HUN;Tapolcai Honvéd SE;Jánoshalma;F;362;N2/10;5193;5650;5840;16683;5392;0;13445;18837;4768;6191;4057;15016;5056;7511;5479;18046;68582;193.0;2017;True;44;5.922452504317789
68.0;Pálfi László ifj;1977;M3;HUN;Tárnok Sprint Egyesület;Budapest;M;254;F1/22;5440;0;12282;17722;5796;5803;7471;19070;4801;5951;3809;14561;5095;7126;5084;17305;68658;193.0;2017;True;40;5.929015544041451
69.0;Finda Péter;1972;M3;HUN;-;Ercsi;M;232;F2/34;5441;5585;6236;17262;5547;5675;7732;18954;4748;6057;3956;14761;5280;0;12483;17763;68740;193.0;2017;True;45;5.9360967184801385
70.0;Veres Gábor;1969;M3;HUN;Spuri SC;Budapest;M;353;F2/35;5378;5427;6107;16912;5457;0;12970;18427;4718;0;9797;14515;5058;7809;6031;18898;68752;193.0;2017;True;48;5.937132987910189
71.0;Bakó Attila;1971;M3;HUN;Győri FutOltók;Kunsziget;M;332;F2/36;5430;5522;6404;17356;5687;0;13462;19149;4660;6096;3847;14603;5041;7420;5190;17651;68759;193.0;2017;True;46;5.937737478411053
72.0;Vasas Levente;1981;M2;HUN;-;Kecskemét;M;268;F1/23;4858;5441;6641;16940;5502;5447;7682;18631;4730;6037;4033;14800;5129;7733;5612;18474;68845;193.0;2017;True;36;5.945164075993092
73.0;Barabás László;1970;M3;HUN;Szigetszentmiklósi Futóklub;Szigetszentmiklós;M;188;F2/37;5338;5556;6012;16906;5513;5472;7951;18936;4718;5922;3885;14525;5040;7666;5807;18513;68880;193.0;2017;True;47;5.948186528497409
74.0;Tabák Péter;1969;M3;HUN;-;Budapest;M;209;F2/38;4929;5355;6481;16765;5648;5583;7953;19184;4715;6052;4073;14840;5065;7426;5640;18131;68920;193.0;2017;True;48;5.951640759930916
75.0;Smart, David;1957;M5;GBR;-;Geneva;M;512;F3/14;5166;0;11030;16196;5396;5482;7810;18688;4860;6395;4093;15348;5218;7624;5918;18760;68992;193.0;2017;True;60;5.957858376511226
14.0;Sima Éva;1961;F4;HUN;PAFF;Paks;F;180;N3/1;5526;5807;5950;17283;5647;5619;7592;18858;4836;0;10135;14971;5253;7650;5475;18378;69490;193.0;2017;True;56;6.000863557858377
76.0;Kalt, Thomaa;1961;M4;GER;-;Langenselbold;M;471;F3/15;5305;0;11947;17252;5530;0;13403;18933;4753;5990;4201;14944;5056;7498;5816;18370;69499;193.0;2017;True;56;6.001640759930915
77.0;Veres, Sandor;1962;M4;GER;AYCM Racing Team;Chemnitz;M;274;F3/16;5181;0;11572;16753;5832;5945;7943;19720;4961;6287;3956;15204;5227;7539;5090;17856;69533;193.0;2017;True;55;6.004576856649396
78.0;Csapó József;1975;M3;HUN;PAFF;Paks (Dunakömlőd);M;175;F2/39;5528;5756;6659;17943;5643;5624;7750;19017;4837;0;9723;14560;5251;7458;5518;18227;69747;193.0;2017;True;42;6.023056994818653
79.0;Lieszkovszky Dávid;1984;M2;HUN;dunafin;Dunaújváros;M;251;F1/24;5145;5464;6240;16849;5542;5933;9170;20645;4711;5874;4023;14608;5019;7219;5568;17806;69908;193.0;2017;True;33;6.036960276338515
80.0;Horváth György dr.;1968;M3;HUN;Gerillasport;Veresegyház;M;143;F2/40;5449;5580;6051;17080;5640;5872;7982;19494;4915;6134;3929;14978;5178;7890;5543;18611;70163;193.0;2017;True;49;6.058981001727116
81.0;Szabó Béla;1963;M4;HUN;-;Gyenesdiás;M;137;F3/17;4674;5024;5996;15694;5314;0;13995;19309;4714;0;10281;14995;5440;0;14764;20204;70202;193.0;2017;True;54;6.062348877374784
82.0;Szőnyi János;1992;M1;HUN;-;Nádudvar;M;167;F1/25;5635;5744;6126;17505;5802;5891;7922;19615;4878;6195;4071;15144;5299;7454;5217;17970;70234;193.0;2017;True;25;6.0651122625215885
83.0;Tóth István;1978;M2;HUN;-;Budapest;M;136;F1/26;5684;0;11853;17537;5751;5748;7624;19123;5155;6751;4061;15967;5340;7042;5339;17721;70348;193.0;2017;True;39;6.074956822107081
84.0;Garancsy Balázs;1972;M3;HUN;Vasemberek Klubja;Budapest;M;151;F2/41;5410;5887;6099;17396;5854;5992;7822;19668;4941;6375;3744;15060;5498;7602;5148;18248;70372;193.0;2017;True;45;6.077029360967185
85.0;Lódi Tamás;1978;M2;HUN;-;Budapest;M;233;F1/27;5678;5708;6288;17674;6057;0;13636;19693;5022;6199;3824;15045;5308;7513;5151;17972;70384;193.0;2017;True;39;6.078065630397236
86.0;Hugyecz Attila;1969;M3;HUN;Gödi Futóklub;Kosd;M;314;F2/42;5354;5604;6277;17235;5796;6114;8188;20098;4893;6128;3920;14941;5443;7527;5601;18571;70845;193.0;2017;True;48;6.117875647668394
87.0;Keret, Rony;1964;M4;ISR;-;Ness Ziona;M;454;F3/18;5689;5765;5873;17327;5805;5681;7854;19340;4972;6205;4147;15324;5409;7670;5918;18997;70988;193.0;2017;True;53;6.130224525043179
88.0;Fullér Zoltán;1970;M3;HUN;-;Pécsvárad;M;147;F2/43;5077;5535;6241;16853;5164;5773;9238;20175;4458;6437;4672;15567;5046;7772;5862;18680;71275;193.0;2017;True;47;6.155008635578584
15.0;Jakab Enikő;1973;F3;HUN;-;Székelyudvarhely;F;303;N2/11;5308;0;13542;18850;5726;5926;7631;19283;4861;6066;3988;14915;5154;0;13082;18236;71284;193.0;2017;True;44;6.1557858376511225
89.0;Schilt László ifj;1994;M1;HUN;-;Kaposvár-Toponár;M;295;F1/28;5233;5488;6228;16949;5688;6051;8669;20408;4772;5897;4434;15103;5530;7801;5578;18909;71369;193.0;2017;True;23;6.1631260794473235
90.0;Ivanov, Alexander;1979;M2;RUS;-;Ekaterinburg;M;451;F1/29;5533;5634;6002;17169;5769;5474;7669;18912;4733;6616;4146;15495;5825;8233;5700;19758;71334;193.0;2017;True;38;6.160103626943005
91.0;Kóder Gábor;1981;M2;HUN;Újpalota SC;Dunakeszi;M;287;F1/30;5016;0;11101;16117;5834;6538;8427;20799;5273;0;10314;15587;5569;0;13451;19020;71523;193.0;2017;True;36;6.176424870466321
92.0;Sutyinszky Tamás;1972;M3;HUN;-;Budapest;M;117;F2/44;5421;0;11868;17289;5678;0;14395;20073;4882;0;10580;15462;5150;0;13572;18722;71546;193.0;2017;True;45;6.178411053540588
93.0;Bödő Imre;1980;M2;HUN;Honvéd Szondi György SE;Kőszeg;M;365;F1/31;5181;5738;6183;17102;5439;6032;8658;20129;4812;6293;4352;15457;5187;8139;5596;18922;71610;193.0;2017;True;37;6.183937823834197
16.0;Hallgató-Csík Ivett;1979;F2;HUN;-;Budapest;F;275;N2/12;5538;0;11660;17198;5586;5773;8350;19709;4943;6369;4124;15436;5456;7974;5792;19222;71565;193.0;2017;True;38;6.180051813471502
17.0;Hangya Andrea;1978;F2;HUN;Zebra Futóklub;Budapest;F;308;N2/13;5519;5809;6369;17697;5867;6020;7870;19757;4926;0;10517;15443;5534;7911;5545;18990;71887;193.0;2017;True;39;6.207858376511226
94.0;Szabó Balázs dr.;1970;M3;HUN;Iron Team;Budapest;M;301;F2/45;5432;6035;6376;17843;5930;5977;7762;19669;5025;6192;4269;15486;5726;7660;5482;18868;71866;193.0;2017;True;47;6.2060449050086355
95.0;Kollár Zoltán;1965;M4;HUN;Knorr-Bremse;Budapest;M;55;F3/19;5677;5944;6674;18295;5973;6136;7639;19748;5116;6496;3822;15434;5346;7575;5445;18366;71843;193.0;2017;True;52;6.20405872193437
96.0;Salamon István;1962;M4;HUN;-;Mezőtárkány;M;34;F3/20;5674;5950;6675;18299;5969;6131;7651;19751;5114;6488;3832;15434;5337;7573;5450;18360;71844;193.0;2017;True;55;6.204145077720208
97.0;Pók János;1963;M4;HUN;Axiál Kft.;Gárdony (Agárd);M;33;F3/21;5673;5955;6666;18294;5978;6130;7644;19752;5117;6489;3827;15433;5356;7581;5444;18381;71860;193.0;2017;True;54;6.20552677029361
98.0;Mata László;1977;M3;HUN;-;Tiszakécske;M;169;F1/32;5350;0;11776;17126;5794;6015;8358;20167;4858;6462;4320;15640;5291;7749;5984;19024;71957;193.0;2017;True;40;6.213903281519862
99.0;Patkós Gábor;1986;M2;HUN;Pénzügyőr SE;Hódmezővásárhely;M;293;F1/33;4710;5905;6826;17441;5235;0;14784;20019;4554;6883;4474;15911;5031;0;13545;18576;71947;193.0;2017;True;31;6.213039723661485
100.0;Szabó Zoltán;1968;M3;HUN;SZVISE Atlétika és Triatlon;Százhalombatta;M;271;F2/46;5494;0;12192;17686;5586;0;13390;18976;4747;6556;4481;15784;5689;0;13855;19544;71990;193.0;2017;True;49;6.216753022452504
101.0;Csavosi Mohammed, Ersinan;1982;M2;USA;-;Budapest;M;472;F1/34;6010;5801;5729;17540;5244;5663;8178;19085;5338;6903;3759;16000;6134;8021;5218;19373;71998;193.0;2017;True;35;6.217443868739205
102.0;Garami Csongor;1968;M3;HUN;-;Törökbálint;M;126;F2/47;5142;0;11416;16558;5521;5795;8638;19954;4783;0;11127;15910;5380;7942;6364;19686;72108;193.0;2017;True;49;6.226943005181347
103.0;Bognár Viktor dr.;1971;M3;HUN;Gödi Futóklub;Göd (Alsógöd);M;245;F2/48;5556;6145;6185;17886;5738;5865;8176;19779;4947;6482;4204;15633;5251;7805;5864;18920;72218;193.0;2017;True;46;6.236442141623489
104.0;Erényi Tamás;1970;M3;HUN;-;Budapest;M;198;F2/49;6045;6161;6516;18722;5930;0;13775;19705;5129;6104;4081;15314;5335;7538;5671;18544;72285;193.0;2017;True;47;6.242227979274611
105.0;Rogy, Johannes Dr;1963;M4;AUT;-;Griffen;M;514;F3/22;5911;6273;6817;19001;6075;6250;8206;20531;5107;6369;3812;15288;5040;7024;5391;17455;72275;193.0;2017;True;54;6.241364421416234
18.0;Zentai Andrea;1981;F2;HUN;GIZIONOK;Budapest;F;289;N2/14;5049;0;12470;17519;5339;5935;8709;19983;4527;0;10971;15498;5036;8194;6092;19322;72322;193.0;2017;True;36;6.245423143350604
106.0;Sipos Sándor;1957;M5;HUN;HASE;Budapest;M;330;F3/23;5510;5715;6058;17283;5779;5856;8673;20308;4922;6490;4631;16043;5415;7716;5737;18868;72502;193.0;2017;True;60;6.260967184801381
19.0;Milus Ilona Tünde;1973;F3;HUN;Futóbarátok - Nike Futóklub Győr;Győr;F;142;N2/15;5715;5984;6190;17889;5885;5920;8254;20059;4954;6406;4288;15648;5484;7666;5878;19028;72624;193.0;2017;True;44;6.271502590673576
107.0;Sebestyén Ádám Dr.;1973;M3;HUN;-;Budapest;M;114;F2/50;5472;5953;6370;17795;5760;6056;8250;20066;4920;0;10431;15351;5416;8222;5734;19372;72584;193.0;2017;True;44;6.268048359240069
108.0;Rudolf József dr.;1970;M3;HUN;-;Budapest;M;128;F2/51;5277;5808;6584;17669;5566;6264;8752;20582;4897;6396;4254;15547;0;0;18848;18848;72646;193.0;2017;True;47;6.273402417962004
109.0;Antal Péter;1968;M3;HUN;-;Budapest;M;292;F2/52;5171;5924;7413;18508;5795;5850;8440;20085;5401;6686;4019;16106;5256;0;12856;18112;72811;193.0;2017;True;49;6.287651122625216
110.0;Geranin, Dmitriy;1987;M2;RUS;Mikkeller running club Moscow;Moscow;M;456;F1/35;5776;0;12224;18000;6002;5881;7908;19791;5164;6427;4053;15644;5655;8217;5383;19255;72690;193.0;2017;True;30;6.27720207253886
111.0;Hullán Botond;1970;M3;HUN;-;Budapest;M;368;F2/53;5647;6226;7182;19055;5714;5924;8266;19904;4809;6374;4074;15257;5258;7578;5820;18656;72872;193.0;2017;True;47;6.292918825561313
112.0;Győrvári Viktor;1974;M3;HUN;-;Nádudvar;M;149;F2/54;5816;6035;6209;18060;5945;0;14427;20372;5171;6782;4576;16529;5300;7510;5164;17974;72935;193.0;2017;True;43;6.298359240069084
113.0;Csordás József;1984;M2;HUN;-;Budapest;M;312;F1/36;5546;5856;5903;17305;5941;0;14595;20536;5106;0;10718;15824;5269;7938;6088;19295;72960;193.0;2017;True;33;6.300518134715026
114.0;Berei Tibor László;1976;M3;HUN;-;Szigetszentmiklós;M;262;F2/55;5338;5558;8293;19189;5718;0;15873;21591;4670;5964;4068;14702;4969;7321;5458;17748;73230;193.0;2017;True;41;6.323834196891192
115.0;Klam Csaba;1970;M3;HUN;-;Soltvadkert;M;29;F2/56;5382;0;14211;19593;5867;5922;7728;19517;5081;6311;4064;15456;0;0;18843;18843;73409;193.0;2017;True;47;6.3392918825561315
20.0;Hugyecz Attiláné;1970;F3;HUN;Gödi Futóklub;Kosd;F;313;N2/16;5557;5950;6285;17792;5842;6115;8188;20145;4965;6408;4231;15604;5481;8321;6274;20076;73617;193.0;2017;True;47;6.357253886010363
116.0;Gyenge Péter;1978;M2;HUN;-;Dunakeszi;M;170;F1/37;5694;0;12203;17897;5842;5727;8044;19613;5189;6491;4209;15889;5769;8156;6304;20229;73628;193.0;2017;True;39;6.358203799654578
21.0;Valter Éva;1972;F3;HUN;-;Fót;F;194;N2/17;5923;6369;6486;18778;6110;6059;8196;20365;5140;6354;4025;15519;5442;7973;5571;18986;73648;193.0;2017;True;45;6.35993091537133
117.0;Földesi József;1957;M5;HUN;Tapolcai Honvéd SE;Tapolca;M;361;F3/24;5422;5669;6926;18017;5841;0;14210;20051;5128;6561;4372;16061;5413;8127;5993;19533;73662;193.0;2017;True;60;6.361139896373057
22.0;Hajdu Krisztina Dr.;1971;F3;HUN;-;Szombathely;F;218;N2/18;5535;6216;7059;18810;6073;6373;8426;20872;4887;6656;4328;15871;5092;7718;5370;18180;73733;193.0;2017;True;46;6.367271157167531
23.0;Szudár Erika;1958;F4;HUN;-;Békéscsaba;F;259;N3/2;5293;6572;7174;19039;5539;5879;8357;19775;4858;6403;4136;15397;5300;8435;6122;19857;74068;193.0;2017;True;59;6.396200345423144
118.0;Molnár Richárd;1965;M4;HUN;Budaörsi DSE;Budaörs;M;317;F3/25;4681;0;12386;17067;6062;6477;9400;21939;4830;0;11008;15838;5308;8163;6125;19596;74440;193.0;2017;True;52;6.42832469775475
119.0;Nacsa Gábor József;1957;M5;HUN;-;Budapest;M;284;F4/1;5823;5856;7809;19488;5792;6111;8305;20208;5195;6795;4272;16262;5537;7854;5367;18758;74716;193.0;2017;True;60;6.452158894645941
120.0;Harrer, Karl;1958;M4;AUT;ÁWF;Sopron;M;283;F3/26;5752;5935;7380;19067;5796;6056;8429;20281;5090;6757;4516;16363;5311;7989;5762;19062;74773;193.0;2017;True;59;6.457081174438687
24.0;Fekete Krisztina;1973;F3;HUN;Minden-kor Női Sportegyesület;Budapest;F;200;N2/19;5516;5784;6112;17412;5923;6068;8267;20258;5268;0;11186;16454;5765;8642;6419;20826;74950;193.0;2017;True;44;6.472366148531952
121.0;Bazsó Tibor;1970;M3;HUN;-;Szombathely;M;223;F2/57;5542;6216;7053;18811;6074;6388;8407;20869;4885;6658;4327;15870;5089;8095;6261;19445;74995;193.0;2017;True;47;6.4762521588946464
25.0;Druskó Zsófia;1966;F3;HUN;Budaörsi DSE;Törökbálint;F;215;N3/3;5595;6242;6697;18534;6130;6418;8832;21380;5384;6917;4496;16797;5355;7479;5574;18408;75119;193.0;2017;True;51;6.486960276338515
122.0;Huber, Hans-Peter;1961;M4;GER;Trisport Erding;Erding;M;466;F3/27;5522;6358;7012;18892;5804;6265;8872;20941;5027;6755;4492;16274;5463;8012;6003;19478;75585;193.0;2017;True;56;6.52720207253886
123.0;Simon Zoltán;1970;M3;HUN;-;Solymár;M;37;F2/58;5679;5940;6679;18298;5976;6268;9139;21383;5089;6726;4572;16387;5343;7980;6286;19609;75677;193.0;2017;True;47;6.535146804835924
124.0;Farkas László;1967;M3;HUN;Futóbolondok SE;Veresegyház;M;20;F2/59;5676;5950;6669;18295;5976;6282;9129;21387;5089;0;11297;16386;5355;8122;6140;19617;75685;193.0;2017;True;50;6.535837651122626
125.0;Zsigri Zoltán;1984;M2;HUN;DK Team;Budapest;M;237;F1/38;5870;5987;6699;18556;6016;6083;8745;20844;5151;6758;4467;16376;5647;8298;6026;19971;75747;193.0;2017;True;33;6.5411917098445596
126.0;Simon Péter;1965;M4;HUN;-;Budapest;M;323;F3/28;5127;5565;6954;17646;5902;6173;9341;21416;5046;6789;4976;16811;5261;8215;6872;20348;76221;193.0;2017;True;52;6.582124352331606
127.0;Béry Norbert;1970;M3;HUN;-;Söpte;M;121;F2/60;5489;5737;6454;17680;5656;5988;8940;20584;5178;7188;4743;17109;5215;8947;6716;20878;76251;193.0;2017;True;47;6.5847150259067355
128.0;Halász Péter;1973;M3;HUN;-;Wien;M;110;F2/61;5581;8364;6249;20194;5832;5862;8721;20415;5086;6742;4825;16653;5602;7705;5870;19177;76439;193.0;2017;True;44;6.6009499136442145
129.0;File Tamás;1972;M3;HUN;-;Sajószentpéter;M;204;F2/62;5557;5833;6385;17775;6070;6454;10425;22949;4859;6600;4759;16218;5907;8238;5668;19813;76755;193.0;2017;True;45;6.6282383419689115
130.0;Körmöczy Zoltán;1971;M3;HUN;Dabasi SE;Vecsés;M;265;F2/63;5939;6380;7408;19727;6170;6227;8633;21030;5227;6741;4137;16105;5962;8165;5968;20095;76957;193.0;2017;True;46;6.645682210708117
131.0;Menesi Tamás;1969;M3;HUN;Sárvár Kinizsi SE;Budapest;M;338;F2/64;5525;6312;7259;19096;6267;6979;9099;22345;5314;6907;4208;16429;5583;8112;5741;19436;77306;193.0;2017;True;48;6.675820379965458
26.0;Menz, Judit;1972;F3;GER;Ultra Team Hohenlohe;Lauda-Königshofen;F;508;N2/20;5954;5918;6020;17892;6503;6410;8733;21646;5293;0;10981;16274;6445;0;15251;21696;77508;193.0;2017;True;45;6.693264248704663
132.0;Bokodi László;1977;M3;HUN;-;Mohács;M;234;F1/39;6035;0;13369;19404;5990;6244;8597;20831;5299;6634;4640;16573;5793;0;0;5793;62601;193.0;2017;True;40;5.405958549222797
27.0;Kovács Nóra dr.;1970;F3;HUN;-;Budapest;F;127;N2/21;5903;6412;6848;19163;6159;6573;8630;21362;5071;6880;4499;16450;5779;8479;6569;20827;77802;193.0;2017;True;47;6.718652849740933
133.0;Szőke Zoltán;1972;M3;HUN;-;Tiszavasvári;M;187;F2/65;5718;6150;6802;18670;6221;6299;8752;21272;5491;7264;4642;17397;5767;8256;6550;20573;77912;193.0;2017;True;45;6.728151986183074
28.0;Reich Orsolya;1981;F2;HUN;-;Tököl;F;220;N2/22;6488;6978;7111;20577;6623;6360;8291;21274;5770;6665;4111;16546;5972;8146;5395;19513;77910;193.0;2017;True;36;6.727979274611399
29.0;Huszák Katalin;1975;F3;HUN;Futeam SE;Szigethalom;F;152;N2/23;5880;6616;6932;19428;6118;6529;8622;21269;5250;7164;4744;17158;5586;8597;6010;20193;78048;193.0;2017;True;42;6.739896373056995
134.0;Venczel Márton;1990;M1;HUN;-;Fót;M;153;F1/40;5521;6437;6857;18815;5757;6206;8844;20807;4951;7081;6747;18779;5517;8521;5961;19999;78400;193.0;2017;True;27;6.770293609671849
30.0;Venczel Réka;1990;F1;HUN;-;Budapest;F;318;N1/4;5519;6441;6855;18815;5763;6211;8838;20812;4951;7070;6758;18779;5520;8522;5961;20003;78409;193.0;2017;True;27;6.771070811744386
31.0;Fejér Zsuzsa;1971;F3;HUN;-;Budapest;F;203;N2/24;5894;6162;6647;18703;6087;6366;8397;20850;5497;0;12307;17804;6045;8929;6254;21228;78585;193.0;2017;True;46;6.786269430051814
135.0;Szigeti Attila;1970;M3;HUN;-;Siófok;M;113;F2/66;5946;6263;7481;19690;6184;6263;9434;21881;5366;7096;4645;17107;5650;8060;6248;19958;78636;193.0;2017;True;47;6.790673575129533
136.0;Karlovitz Máté;1975;M3;HUN;-;Budapest;M;270;F2/67;6171;6615;7857;20643;6464;6464;8942;21870;5159;6655;4434;16248;5567;8398;6052;20017;78778;193.0;2017;True;42;6.80293609671848
137.0;Bokor Béla;1971;M3;HUN;-;Csákvár;M;257;F2/68;5568;6022;7177;18767;6212;6460;8790;21462;5521;7568;4819;17908;5927;8679;6221;20827;78964;193.0;2017;True;46;6.818998272884283
32.0;Schneller Erika;1968;F3;HUN;Iron Team;Szentendre;F;108;N2/25;5715;6055;6499;18269;6137;6750;8877;21764;5393;7267;4706;17366;5812;9087;6815;21714;79113;193.0;2017;True;49;6.831865284974093
138.0;Győri Gábor;1970;M3;HUN;Fuszekli Kaposvár;Kaposvár;M;272;F2/69;5932;6830;7153;19915;6301;6804;9817;22922;5385;7908;4927;18220;5652;7016;5457;18125;79182;193.0;2017;True;47;6.837823834196891
139.0;Gazsi Péter;1986;M2;HUN;-;Budapest;M;249;F1/41;5792;6137;8267;20196;6104;6268;9525;21897;5289;6931;4378;16598;5701;8143;6760;20604;79295;193.0;2017;True;31;6.8475820379965455
140.0;Telek Péter;1992;M1;HUN;-;Nagykovácsi;M;319;F1/42;5819;6148;6947;18914;6079;6474;9390;21943;5397;7081;4669;17147;5802;8886;6786;21474;79478;193.0;2017;True;25;6.863385146804837
141.0;Eriksson, Roland;1967;M3;SWE;Team Marathonguidema;Fellingsbro;M;510;F2/70;5512;6004;6860;18376;6348;6695;9177;22220;5504;7315;4857;17676;6201;8606;6450;21257;79529;193.0;2017;True;50;6.8677892918825565
142.0;Burén, Hans;1965;M4;SWE;Team Marathonguidema;Örebro;M;509;F3/29;5515;5998;6863;18376;6349;6702;9171;22222;5508;7304;4865;17677;6201;8612;6446;21259;79534;193.0;2017;True;52;6.868221070811744
143.0;Gál Imre;1970;M3;HUN;-;Nádudvar;M;154;F2/71;5989;6389;7521;19899;6183;6251;9276;21710;5366;7546;4976;17888;5520;8045;6563;20128;79625;193.0;2017;True;47;6.8760794473229705
144.0;Rogy, Maximilian;1962;M4;AUT;-;Griffen;M;513;F3/30;5914;6313;7167;19394;6210;6424;9512;22146;5115;6360;4761;16236;6087;9666;6363;22116;79892;193.0;2017;True;55;6.899136442141623
145.0;Nagy Attila;1978;M2;HUN;-;Budapest;M;278;F1/43;5459;6051;7020;18530;5766;6471;8948;21185;5090;8070;4229;17389;5949;10005;6867;22821;79925;193.0;2017;True;39;6.901986183074266
33.0;Fodor Ágnes;1976;F3;HUN;-;Debrecen;F;273;N2/26;5815;6454;7174;19443;5945;7046;9394;22385;5540;7244;4577;17361;5779;8688;6358;20825;80014;193.0;2017;True;41;6.909671848013817
34.0;Lakatos Éva;1973;F3;HUN;Fóti Futóklub;Fót;F;196;N2/27;5951;6315;7501;19767;6594;6628;8950;22172;5737;7308;4402;17447;5995;0;14659;20654;80040;193.0;2017;True;44;6.9119170984455955
146.0;Matavovszky György;1962;M4;HUN;-;Nyíregyháza;M;348;F3/31;5886;0;13162;19048;6490;6565;8839;21894;5719;0;11897;17616;6171;8932;6468;21571;80129;193.0;2017;True;55;6.9196027633851465
147.0;Bakos Gábor;1966;M4;HUN;-;Dunakeszi;M;201;F3/32;5429;0;13895;19324;6039;6284;8890;21213;5220;7682;5082;17984;6054;9425;6208;21687;80208;193.0;2017;True;51;6.926424870466321
148.0;Küllős Máté;1974;M3;HUN;-;Göd (Alsógöd);M;277;F2/72;5553;6270;7503;19326;6395;6633;9079;22107;5598;7108;4576;17282;5986;0;15664;21650;80365;193.0;2017;True;43;6.939982728842833
35.0;Viniczai Andrea;1976;F3;HUN;SUHANJ!;Budapest;F;246;N2/28;5906;6420;6998;19324;6398;6630;9086;22114;5597;7099;4581;17277;6026;8982;6658;21666;80381;193.0;2017;True;41;6.941364421416235
149.0;Lajszner Lajos;1966;M4;HUN;Egri triatlon klub;Eger;M;174;F3/33;5290;6394;7174;18858;5915;6200;8991;21106;5109;6995;4929;17033;5682;9916;7858;23456;80453;193.0;2017;True;51;6.947582037996546
150.0;Gnauert, Rene;1972;M3;GER;-;Berlin;M;462;F2/73;6007;6366;7135;19508;6386;6635;9073;22094;5598;7120;4566;17284;6017;8977;6654;21648;80534;193.0;2017;True;45;6.954576856649395
151.0;Csiki-Imre Attila;1987;M2;HUN;-;Székelyudvarhely;M;260;F1/44;5427;0;14965;20392;6104;6892;9756;22752;5669;0;12342;18011;5837;7922;5880;19639;80794;193.0;2017;True;30;6.977029360967184
152.0;Schwarzwald, Hans;1963;M4;GER;THOHAN;Erfurt;M;455;F3/34;6066;6724;7443;20233;6225;6596;9544;22365;5365;7076;5028;17469;5906;8464;6875;21245;81312;193.0;2017;True;54;7.021761658031088
153.0;Szabó Zoltán Dr.;1958;M4;HUN;-;Dunaújváros;M;132;F3/35;5810;6706;7265;19781;5858;6348;9021;21227;5444;7843;4964;18251;5885;9011;7300;22196;81455;193.0;2017;True;59;7.034110535405872
154.0;Dobák Zsolt;1980;M2;HUN;-;Tatabánya;M;276;F1/45;6294;6980;8304;21578;6800;6757;9324;22881;5632;7066;4605;17303;5884;7917;6051;19852;81614;193.0;2017;True;37;7.047841105354059
36.0;Benya Diana;1981;F2;HUN;-;Budapest;F;192;N2/29;5283;5737;5975;16995;5721;6238;10293;22252;5846;0;13811;19657;6254;9687;6933;22874;81778;193.0;2017;True;36;7.062003454231434
37.0;Koroknai Krisztina dr.;1981;F2;HUN;-;Herceghalom;F;138;N2/30;6227;6697;6639;19563;6463;6600;9093;22156;5778;7303;4869;17950;6032;9000;7206;22238;81907;193.0;2017;True;36;7.07314335060449
38.0;Garancsyné Cserhalmi Ágnes;1976;F3;HUN;Ironteam SE;Budapest;F;150;N2/31;5905;6621;7382;19908;6398;7086;8633;22117;5598;7107;4578;17283;6027;9103;7527;22657;81965;193.0;2017;True;41;7.078151986183074
39.0;Szalma Rita;1970;F3;HUN;-;Budapest;F;263;N2/32;5719;6285;7096;19100;6171;6649;9698;22518;5340;7643;5094;18077;6079;9253;7039;22371;82066;193.0;2017;True;47;7.0868739205526765
155.0;Árgyelán Krisztián;1976;M3;HUN;Fősör FC;Kétegyháza;M;139;F2/74;5533;6082;6688;18303;6360;6729;9757;22846;5675;7413;4885;17973;6526;9606;7148;23280;82402;193.0;2017;True;41;7.115889464594127
156.0;Mihalik Zoltán;1979;M2;HUN;-;Budapest;M;221;F1/46;6169;6404;7155;19728;6270;6775;9391;22436;5427;7678;4728;17833;6282;9700;6311;22293;82290;193.0;2017;True;38;7.106217616580311
157.0;Szlaukó Róbert;1979;M2;HUN;Süssön Rád a Nap;Budapest;M;141;F1/47;5437;6757;7574;19768;6265;6700;9732;22697;5553;7599;4935;18087;5844;0;15900;21744;82296;193.0;2017;True;38;7.106735751295337
40.0;Oláhné Császi Eszter;1979;F2;HUN;-;Nádudvar;F;282;N2/33;6006;6605;6631;19242;6279;7216;8687;22182;5552;7318;5394;18264;6025;0;17191;23216;82904;193.0;2017;True;38;7.159240069084629
158.0;Ridly István Attila;1981;M2;HUN;Négy Égtáj SE;Nyergesújfalu;M;172;F1/48;5946;6289;6950;19185;6108;6671;10011;22790;5509;7715;4926;18150;5968;9377;7581;22926;83051;193.0;2017;True;36;7.171934369602764
159.0;Heitfeldt, Ulrich;1957;M5;GER;LG Fulda;Hohenhameln;M;460;F3/36;5604;0;13683;19287;6213;6944;10458;23615;5421;7159;5174;17754;5982;9056;7579;22617;83273;193.0;2017;True;60;7.191105354058722
160.0;Kakuszi József;1983;M2;HUN;-;Hódmezővásárhely;M;351;F1/49;5993;6418;9165;21576;6602;6739;10364;23705;4612;6649;4560;15821;5863;9245;7154;22262;83364;193.0;2017;True;34;7.1989637305699485
41.0;Hirth Csilla;1975;F3;HUN;-;Bonyhád (Majos);F;115;N2/34;6058;6675;7458;20191;6430;6526;9248;22204;5635;7624;4909;18168;6113;8989;7710;22812;83375;193.0;2017;True;42;7.199913644214162
161.0;Horváth Zsolt;1977;M3;HUN;-;Balatonalmádi;M;335;F1/50;5813;6902;8129;20844;6426;6583;9484;22493;5561;7598;4833;17992;5881;9012;7284;22177;83506;193.0;2017;True;40;7.211226252158895
162.0;Kincse Szabolcs;1973;M3;HUN;-;Budakeszi;M;144;F2/75;6004;6719;8124;20847;6441;6845;10136;23422;5611;7140;4882;17633;6016;8969;6711;21696;83598;193.0;2017;True;44;7.219170984455959
163.0;Neveselyi, Vladyslav;1982;M2;UKR;Sapik team;Voznesensk;M;461;F1/51;4579;5302;6865;16746;5828;7000;9993;22821;4962;8880;5335;19177;6784;11073;7137;24994;83738;193.0;2017;True;35;7.23126079447323
164.0;Hattyasy László;1971;M3;HUN;-;Göd (Felsőgöd);M;202;F2/76;5343;6672;7930;19945;6021;6192;9000;21213;5519;8061;4703;18283;6874;9852;7838;24564;84005;193.0;2017;True;46;7.254317789291882
42.0;Bozsó Ágnes;1983;F2;HUN;-;Szeged;F;157;N1/5;6224;6613;7030;19867;6714;7059;9491;23264;5796;7674;5281;18751;6675;9344;6633;22652;84534;193.0;2017;True;34;7.300000000000001
43.0;Fóris Ágnes;1973;F3;HUN;-;Gödöllő;F;342;N2/35;5726;6583;7516;19825;6110;6989;10356;23455;5828;8021;5228;19077;5944;9227;6949;22120;84477;193.0;2017;True;44;7.295077720207254
165.0;Tiger Zoltán;1977;M3;HUN;MH. 86 SZHB;Szolnok;M;349;F1/52;6018;6940;8439;21397;6371;0;17343;23714;5357;7779;5161;18297;0;14837;6310;21147;84555;193.0;2017;True;40;7.301813471502591
166.0;Dzsupin István;1969;M3;HUN;-;Pomáz;M;325;F2/77;6033;6963;7592;20588;6733;7170;10410;24313;5845;7592;5335;18772;5925;9100;6555;21580;85253;193.0;2017;True;48;7.362089810017272
44.0;Baráth Anette Lora;1971;F3;HUN;-;Debrecen Pallag;F;210;N2/36;5487;6660;7667;19814;6104;7016;9903;23023;5541;8110;5032;18683;6255;10279;7576;24110;85630;193.0;2017;True;46;7.394645941278066
45.0;Bálits Éva;1966;F3;HUN;-;Diósd;F;205;N3/4;6460;7458;8273;22191;6718;6954;9958;23630;5898;7570;4884;18352;6235;8893;6480;21608;85781;193.0;2017;True;51;7.407685664939551
46.0;Rajki Edit;1980;F2;HUN;Angyalcipők;Budapest;F;162;N2/37;6232;6695;6984;19911;6575;6899;9951;23425;5766;7831;5124;18721;6459;9956;7470;23885;85942;193.0;2017;True;37;7.421588946459412
167.0;Kovács Herman;1982;M2;HUN;-;Nádudvar;M;112;F1/53;6237;6756;7872;20865;6800;7294;10063;24157;5849;7616;4973;18438;6462;9274;7073;22809;86269;193.0;2017;True;35;7.449827288428325
47.0;Véghné Gergely Mónika;1982;F2;HUN;Nagypályás KSE;Füzesabony;F;231;N1/6;6166;6918;7861;20945;6357;7193;10029;23579;5757;8213;4831;18801;6295;9995;6972;23262;86587;193.0;2017;True;35;7.477288428324697
168.0;Jeney Gábor;1977;M3;HUN;DSE;Nagymaros;M;331;F1/54;5096;5983;7332;18411;6045;7352;11114;24511;6003;8486;5232;19721;6124;10019;7948;24091;86734;193.0;2017;True;40;7.489982728842832
169.0;Országh Péter;1978;M2;HUN;-;Biatorbágy;M;140;F1/55;6166;6033;6693;18892;6631;0;17497;24128;5824;7775;5676;19275;0;16442;8040;24482;86777;193.0;2017;True;39;7.493696027633852
170.0;Keresztesi Tamás;1983;M2;HUN;Ironteam SE;Rácalmás;M;281;F1/56;5909;6803;8665;21377;6709;7270;10604;24583;5742;7714;5435;18891;6102;9121;7240;22463;87314;193.0;2017;True;34;7.54006908462867
171.0;Czabán László Dr.;1968;M3;HUN;-;Jakabszállás;M;130;F2/78;6332;7159;7090;20581;6855;7399;10370;24624;5990;8270;4548;18808;6509;9685;7268;23462;87475;193.0;2017;True;49;7.553972366148533
48.0;Sebestyén Linda;1980;F2;HUN;-;Budapest;F;241;N2/38;5902;7473;7709;21084;6638;7701;10162;24501;5702;8180;5166;19048;6325;9894;7213;23432;88065;193.0;2017;True;37;7.6049222797927465
172.0;Balogh Ádám;1979;M2;HUN;BKV Előre SC;Budapest;M;145;F1/57;6249;6081;8174;20504;6224;7333;10245;23802;5668;9550;5289;20507;5253;9797;8992;24042;88855;193.0;2017;True;38;7.673143350604491
173.0;Kreszta Zoltán;1970;M3;HUN;-;Budapest;M;11;F2/79;5566;7126;8869;21561;6429;6909;11117;24455;5688;8081;5149;18918;6382;9711;8266;24359;89293;193.0;2017;True;47;7.710967184801381
174.0;Nilsson, Jörgen;1950;M5;SWE;Vi som springer;Hisingkärra;M;504;F4/2;6221;7116;7889;21226;6898;7414;10772;25084;6142;8252;5544;19938;6791;9722;7322;23835;90083;193.0;2017;True;67;7.779188255613127
175.0;Holové Péter;1983;M2;HUN;Knorr-Bremse;Budapest;M;207;F1/58;6603;7181;7285;21069;7271;7559;10331;25161;6369;8558;5630;20557;6445;9806;7334;23585;90372;193.0;2017;True;34;7.804145077720207
49.0;Bienicke, Beate;1968;F3;GER;-;Giessen;F;453;N2/39;6536;7069;7811;21416;6731;7131;10645;24507;6002;8322;5324;19648;6589;10325;7974;24888;90459;193.0;2017;True;49;7.811658031088084
176.0;Laig, Uwe;1957;M5;GER;-;Lengerich;M;464;F3/37;6538;7077;7803;21418;6733;7137;10637;24507;6023;8310;5309;19642;6589;10357;7947;24893;90460;193.0;2017;True;60;7.811744386873921
177.0;Hack Román Antal;1974;M3;HUN;Hack-i mer az nyer;Nyergesújfalu;M;25;F2/80;5635;6222;8014;19871;6335;7811;9703;23849;5861;8920;5830;20611;7173;11293;7913;26379;90710;193.0;2017;True;43;7.833333333333333
178.0;Blücher, Tord;1958;M4;SWE;Storädalens LDK;Stora;M;507;F3/38;6229;7106;7890;21225;6923;7501;11270;25694;6203;8600;5500;20303;6794;10670;7636;25100;92322;193.0;2017;True;59;7.972538860103628
179.0;Wikström, Staffan;1955;M5;SWE;Vattudalens LDK;Strömsund;M;506;F4/3;6222;7117;7901;21240;6914;7507;11269;25690;6191;8504;5596;20291;6794;10670;7644;25108;92329;193.0;2017;True;62;7.97314335060449
180.0;Keresztes János;1966;M4;HUN;-;Budapest;M;336;F3/39;6176;6940;8461;21577;6933;7579;10184;24696;6383;8934;5485;20802;6539;11287;7869;25695;92770;193.0;2017;True;51;8.011226252158895
181.0;Tóth Iván Csaba;1974;M3;HUN;Fót SE Atlétika;Fót;M;285;F2/81;6360;7449;7643;21452;7229;7836;11683;26748;6297;8966;6021;21284;7139;9969;7053;24161;93645;193.0;2017;True;43;8.086787564766839
999.0;Iváncsics Zsolt;1968;M3;HUN;EMU;Orosháza;M;327;;6074;7071;0;13145;0;0;0;0;0;0;0;0;0;0;0;0;13145;36.0;2017;False;49;6.085648148148149
999.0;Hergovits Gábor;1965;M4;HUN;Honvéd Szondi SE;Székesfehérvár;M;364;;5003;5129;5093;15225;5134;5108;7174;17416;4533;5744;3960;14237;5605;0;0;5605;52483;158.0;2017;False;52;5.536181434599157
999.0;Korcsmáros Tamás;1972;M3;HUN;-;Békéscsaba;M;291;;6578;0;14862;21440;7254;0;19018;26272;0;0;0;0;6036;0;15310;21346;69058;150.0;2017;False;45;7.673111111111111
999.0;Nagy Zsófia;1976;F3;HUN;Fót SE Atlétika;Fót;F;133;;6360;7405;7686;21451;7231;7834;11686;26751;6293;8891;6098;21282;0;0;0;0;69484;143.0;2017;False;41;8.098368298368298
999.0;Barkman, Raymond;1964;M4;NED;-;Rotterdam;M;476;;0;0;0;0;6765;7069;10264;24098;6172;8003;5032;19207;6165;9426;6360;21951;65256;145.0;2017;False;53;7.500689655172414
999.0;Petring, Thorsten;1969;M3;GER;-;Erfurt;M;473;;6067;6717;7451;20235;6226;6589;9555;22370;5369;7090;5396;17855;0;0;0;0;60460;143.0;2017;False;48;7.046620046620046
999.0;Balog Andor;1983;M2;HUN;-;Tatabánya;M;288;;5178;5235;5579;15992;5488;5594;7492;18574;4704;5854;3883;14441;6345;0;0;6345;55352;158.0;2017;False;34;5.838818565400843
999.0;Szakács Tímea;1981;F2;HUN;MH EK;Budapest;F;358;;5572;6524;0;12096;5958;6322;11189;23469;5503;7858;6037;19398;0;0;0;0;54963;127.0;2017;False;36;7.212992125984251
999.0;Czeglédy Csaba dr.;1976;M3;HUN;-;Szombathely;M;103;;5218;5919;6729;17866;6059;6367;9340;21766;5448;7707;5063;18218;0;0;0;0;57850;143.0;2017;False;41;6.742424242424242
999.0;Feszt István Richárd;1993;M1;HUN;-;Budapest;M;309;;5102;6702;8609;20413;5859;8401;0;14260;5907;9013;5291;20211;5584;10331;8918;24833;79717;172.0;2017;False;24;7.724515503875969
999.0;Frank Tibor;1949;M5;HUN;EMU;Budapest;M;179;;6004;0;12683;18687;6441;0;16416;22857;5907;0;12932;18839;6328;0;0;6328;66711;158.0;2017;False;68;7.037025316455695
999.0;Vass Melinda dr.;1979;F2;HUN;-;Budapest;F;195;;5827;6446;7053;19326;6097;6837;9838;22772;0;0;0;0;0;0;0;0;42098;101.0;2017;False;38;6.946864686468647
999.0;Fejes László;1973;M3;HUN;DK Team;Budapest;M;243;;5858;0;12639;18497;6086;6256;9150;21492;5692;0;11553;17245;0;0;0;0;57234;143.0;2017;False;44;6.670629370629371
999.0;Czunyi Károly;1990;M1;HUN;-;Budapest;M;183;;4033;0;8638;12671;4316;4411;6095;14822;4064;0;0;4064;0;0;0;0;31557;115.0;2017;False;27;4.573478260869566
999.0;Paraniak, Jan;1950;M5;SWE;Team Skavsärer IF;Huddinge;M;502;;5711;6479;8804;20994;6051;6930;10930;23911;0;0;0;0;0;0;0;0;44905;101.0;2017;False;67;7.41006600660066
999.0;Gábriel Nikolett;1979;F2;HUN;-;Budapest;F;116;;6369;7534;8003;21906;7362;8531;11012;26905;0;0;0;0;0;0;0;0;48811;101.0;2017;False;38;8.054620462046204
999.0;Pátkai Attila;1970;M3;HUN;-;Szombathely;M;105;;5539;0;15290;20829;0;0;0;0;5127;0;10768;15895;5495;8389;6294;20178;56902;140.0;2017;False;47;6.774047619047619
999.0;Kovács László;1979;M2;HUN;-;Kecskemét;M;252;;5748;5737;6475;17960;6001;6713;11331;24045;0;0;0;0;0;0;0;0;42005;101.0;2017;False;38;6.931518151815182
999.0;Paraniak, Barbro;1956;F4;SWE;Team Skavsärer IF;Huddinge;F;503;;0;0;0;0;7106;0;19567;26673;0;0;0;0;0;0;0;0;26673;49.0;2017;False;61;9.072448979591837
999.0;Wiesler, Peter;1955;M5;SWE;Team Skavsärer IF;Akersberga;M;505;;0;0;0;0;0;0;0;0;0;0;0;0;6322;9545;7341;23208;23208;49.0;2017;False;62;7.893877551020409
999.0;Szekeres Nyúl;1967;F3;HUN;Futóbolondok SE;Budapest;F;213;;6248;6940;8455;21643;0;0;0;0;0;0;0;0;0;0;0;0;21643;49.0;2017;False;50;7.36156462585034
999.0;Herczku Tímea;1985;F2;HUN;-;Budapest;F;229;;4725;4853;5161;14739;4927;5011;7198;17136;4426;6382;4949;15757;0;0;0;0;47632;143.0;2017;False;32;5.551515151515152
999.0;Kecskés Tamás;1970;M3;HUN;Futóbarátok - Nike Futóklub Győr;Győrszemere;M;199;;5342;0;14311;19653;0;0;0;0;4860;7433;4827;17120;5377;9430;7595;22402;59175;140.0;2017;False;47;7.044642857142857
999.0;Kádár-Csoboth Péter;1978;M2;HUN;Futóbolondok SE;Budapest;M;267;;4525;4608;4738;13871;4611;4591;0;9202;0;0;0;0;0;0;0;0;23073;65.0;2017;False;39;5.916153846153846
999.0;Möhr, Andrea;1965;F3;GER;LG Mauerweg Berlin e.V.;Berlin;F;501;;6109;7000;7504;20613;6549;7432;10207;24188;0;0;0;0;6432;8591;5520;20543;65344;150.0;2017;False;52;7.2604444444444445
999.0;Lipták Zita;1986;F2;HUN;-;Budapest;F;227;;5147;5494;5968;16609;5574;6251;9768;21593;5349;0;0;5349;0;0;0;0;43551;115.0;2017;False;31;6.311739130434783
999.0;Tóth Gábor;1967;M3;HUN;Futóbarátok - Nike Futóklub Győr;Ikrény;M;248;;5943;6795;8637;21375;6888;7491;0;14379;0;0;0;0;0;0;0;0;35754;64.0;2017;False;50;9.3109375
999.0;Nedeczky László Tamás;1984;M2;HUN;HP;Budapest;M;125;;5011;0;13010;18021;0;0;0;0;0;0;0;0;0;0;0;0;18021;49.0;2017;False;33;6.129591836734694
999.0;Zsigri Szabolcs dr.;1976;M3;HUN;DK Team;Budapest;M;102;;6265;7337;8360;21962;7223;8385;11328;26936;0;0;0;0;0;0;0;0;48898;101.0;2017;False;41;8.068976897689769
999.0;Hüttner Miklós;1976;M3;HUN;-;Budapest;M;177;;5554;0;14511;20065;0;0;0;0;0;0;0;0;0;0;0;0;20065;49.0;2017;False;41;6.82482993197279
1.0;Steib Péter;1980;M2;HUN;TF;Szigetszentmárton;M;320;1 / F1;3968;3981;3960;11909;4068;3985;5363;13416;3403;4460;3654;11517;3874;5269;3931;13074;49916;195.0;2016;True;36;4.266324786324786
2.0;Lux, Christoph;1978;M2;GER;TG Viktoria Augsburg/ LC Altdorf;Altdorf;M;468;2 / F1;0;0;12206;12206;4116;4025;5579;13720;3456;4427;3835;11718;3895;5383;3998;13276;50920;195.0;2016;True;38;4.352136752136752
3.0;Csécsei Zoltán;1984;M2;HUN;Szufla SE;Marcali;M;317;3 / F1;4029;4024;4064;12117;4120;4017;5936;14073;3570;4836;4165;12571;4142;5508;4273;13923;52684;195.0;2016;True;32;4.502905982905983
4.0;Roskovics Miklós;1970;M3;HUN;-;Érd;M;329;1 / F2;4031;4033;4236;12300;4331;4221;6219;14771;3689;4770;4142;12601;4147;5624;4365;14136;53808;195.0;2016;True;46;4.598974358974359
5.0;Kaluz Ákos Bertalan;1981;M2;HUN;Honvéd Szondi SE;Seregélyes;M;324;4 / F1;4446;4548;4752;13746;4449;4409;6516;15374;3722;4801;4139;12662;4128;5697;4506;14331;56113;195.0;2016;True;35;4.795982905982906
6.0;Tóth Csaba;1973;M3;HUN;HASE;Budapest;M;260;2 / F2;4033;4284;5086;13403;4308;4553;7058;15919;3687;4822;4235;12744;4130;5686;4533;14349;56415;195.0;2016;True;43;4.8217948717948715
7.0;Kozma Zsolt;1987;M2;HUN;Futeam SE;Tök;M;153;5 / F1;4171;4441;5188;13800;4449;4754;6788;15991;3711;4819;4314;12844;4132;5736;4536;14404;57039;195.0;2016;True;29;4.875128205128205
8.0;Toldi Péter;1981;M2;HUN;-;Szeged;M;190;6 / F1;4720;4730;4849;14299;4782;4661;6314;15757;4010;5001;4264;13275;4352;5597;3823;13772;57103;195.0;2016;True;35;4.88059829059829
9.0;Hönsch Viktor;1959;M4;HUN;-;Budapest;M;298;1 / F3;4392;4422;4947;13761;4647;4842;6896;16385;3688;4870;4252;12810;4233;6045;4685;14963;57919;195.0;2016;True;57;4.950341880341881
10.0;Bognár Ákos dr.;1977;M2;HUN;-;Érd;M;217;7 / F1;4604;4613;4849;14066;4660;4619;6530;15809;3900;5055;4316;13271;4269;5853;4770;14892;58038;195.0;2016;True;39;4.96051282051282
11.0;Elford, Nick;1976;M3;GBR;-;Woking;M;401;8 / F1;4283;4505;4605;13393;4602;4645;7258;16505;3800;4901;4286;12987;4286;6195;4753;15234;58119;195.0;2016;True;40;4.967435897435897
12.0;Elford, Robert;1983;M2;GBR;-;Fernhurst;M;422;9 / F1;4257;4419;4728;13404;4600;4670;6698;15968;3866;5269;4885;14020;4365;6132;4693;15190;58582;195.0;2016;True;33;5.007008547008547
13.0;Kollin Gábor Gergely;1972;M3;HUN;Spuri SC;Budapest;M;126;3 / F2;4675;4881;4954;14510;4914;4815;6690;16419;4081;5243;4365;13689;4349;6164;4367;14880;59498;195.0;2016;True;44;5.085299145299145
1.0;Ladányi Tímea;1986;F2;HUN;MAC;Budapest;F;252;1 / N1;4443;4683;4887;14013;4676;4818;6788;16282;3957;5492;4607;14056;4408;6228;4630;15266;59617;195.0;2016;True;30;5.095470085470086
14.0;Tigyi László;1960;M4;HUN;BFC Futapest;Budapest;M;131;2 / F3;4411;4504;5364;14279;4679;4844;7185;16708;3878;5153;4524;13555;4349;6120;4829;15298;59840;195.0;2016;True;56;5.114529914529915
15.0;Nagy Imre;1981;M2;HUN;Záróbusz Felvezetők ESK;Egyek;M;296;10 / F1;4519;4736;5155;14410;4702;5008;6730;16440;3790;5174;4542;13506;4453;6184;5092;15729;60085;195.0;2016;True;35;5.135470085470085
16.0;Márkus István;1972;M3;HUN;Kadarka Futóegyesület;Szekszárd;M;177;4 / F2;4622;0;9974;14596;4978;0;11998;16976;4082;5261;4482;13825;4458;6158;4548;15164;60561;195.0;2016;True;44;5.176153846153846
17.0;Dóbé Zsolt;1974;M3;HUN;-;Szeged;M;152;5 / F2;0;8202;5447;13649;4366;5205;8609;18180;3837;5263;4748;13848;4266;6012;4613;14891;60568;195.0;2016;True;42;5.176752136752137
2.0;Molnár Gitta;1983;F2;HUN;-;Békéscsaba;F;322;2 / N1;4758;4864;5303;14925;4936;5009;7300;17245;4021;5080;4326;13427;4318;6097;4621;15036;60633;195.0;2016;True;33;5.182307692307692
18.0;Kertész Ervin;1970;M3;HUN;Futóbarátok Egyyesület Győr;Ásványráró;M;112;6 / F2;4608;4771;5035;14414;5004;5111;7970;18085;4013;5147;4432;13592;4480;6389;4757;15626;61717;195.0;2016;True;46;5.274957264957265
3.0;Kelemen Nóra;1972;F3;HUN;B784 Team;Balatonkenese;F;284;1 / N2;4836;0;10073;14909;0;9771;6738;16509;4100;0;10018;14118;4654;6620;5035;16309;61845;195.0;2016;True;44;5.285897435897436
19.0;Pók János;1963;M4;HUN;Axiál Kft.;Gárdony (Agárd);M;33;3 / F3;4624;4945;5176;14745;4965;0;12095;17060;4053;5410;4669;14132;4413;6492;5131;16036;61973;195.0;2016;True;53;5.296837606837608
20.0;Balogh Róbert;1980;M2;HUN;-;Békéscsaba;M;133;11 / F1;5201;0;10744;15945;5016;0;12102;17118;4043;5344;4437;13824;4347;0;10763;15110;61997;195.0;2016;True;36;5.2988888888888885
21.0;Bakó Gábor;1968;M3;HUN;-;Budakalász;M;205;7 / F2;4427;4896;5266;14589;5223;5225;7628;18076;3952;5196;4920;14068;4380;6369;4980;15729;62462;195.0;2016;True;48;5.338632478632478
22.0;Görgényi András;1976;M3;HUN;-;Békéscsaba;M;161;12 / F1;5069;5169;5507;15745;5178;5050;6858;17086;4270;5573;4624;14467;4587;6397;4781;15765;63063;195.0;2016;True;40;5.39
23.0;Soós Elek;1970;M3;HUN;VUK Se;Százhalombatta;M;117;8 / F2;4539;4692;5454;14685;4990;4854;7651;17495;4042;0;9900;13942;4500;6707;5762;16969;63091;195.0;2016;True;46;5.392393162393162
24.0;Károlyi János;1963;M4;HUN;-;Mezőberény;M;171;4 / F3;4958;5194;5685;15837;5042;5169;7694;17905;4030;5477;4846;14353;4449;6369;4923;15741;63836;195.0;2016;True;53;5.456068376068377
25.0;Juhász Mihály Dr.;1967;M3;HUN;-;Csongrád;M;213;9 / F2;5089;5039;5491;15619;5493;5367;7075;17935;4257;5356;4574;14187;4853;6288;4897;16038;63779;195.0;2016;True;49;5.451196581196581
26.0;Patkós Gábor;1986;M2;HUN;Pénzügyőr SE;Hódmezővásárhely;M;302;13 / F1;4625;4953;5928;15506;4798;5346;8175;18319;3967;5587;4859;14413;4343;6480;4942;15765;64003;195.0;2016;True;30;5.470341880341881
27.0;Pálfi János;1977;M2;HUN;-;Waterloo;M;218;14 / F1;4214;4677;5999;14890;4668;5155;7888;17711;3937;5429;5148;14514;4378;6882;5671;16931;64046;195.0;2016;True;39;5.4740170940170945
28.0;Salamon István;1962;M4;HUN;-;Mezőtárkány;M;34;5 / F3;5013;5168;5738;15919;5131;5111;7586;17828;4061;5452;4847;14360;4539;6483;5167;16189;64296;195.0;2016;True;54;5.495384615384615
4.0;Axelsson, Gunilla;1988;F2;SWE;Borlange LK;Borlange;F;475;3 / N1;5350;5300;5436;16086;5146;5340;7295;17781;4303;5551;4762;14616;4591;6532;4868;15991;64474;195.0;2016;True;28;5.51059829059829
29.0;Kiss Sándor;1965;M4;HUN;-;Görcsöny;M;321;6 / F3;4857;5217;5878;15952;5157;5414;7431;18002;4125;5611;4844;14580;4584;6623;5009;16216;64750;195.0;2016;True;51;5.534188034188035
5.0;Csapó Judit;1973;F3;HUN;Teljesítménytúrázók Társasága;Osztopán;F;279;2 / N2;4716;5153;5747;15616;5112;5520;7369;18001;4186;5881;5178;15245;4590;6652;4713;15955;64817;195.0;2016;True;43;5.53991452991453
6.0;Szilágyi Szvetlana;1976;F3;HUN;-;Békéscsaba;F;220;3 / N2;5201;5350;5489;16040;5356;5347;7096;17799;4461;5832;4805;15098;4723;6560;4631;15914;64851;195.0;2016;True;40;5.542820512820512
30.0;Szabó Béla;1963;M4;HUN;-;Gyenesdiás;M;155;7 / F3;5079;0;10073;15152;5048;5196;7715;17959;4353;0;10844;15197;4710;0;12230;16940;65248;195.0;2016;True;53;5.576752136752137
31.0;Rakonczai Gábor;1981;M2;HUN;-;Pusztazámor;M;316;15 / F1;4509;0;10088;14597;4777;0;13185;17962;4173;0;10949;15122;4736;7008;5621;17365;65046;195.0;2016;True;35;5.559487179487179
32.0;Blaskó Mihály;1980;M2;HUN;-;Monorierdő;M;229;16 / F1;4583;4756;5245;14584;5184;5374;8152;18710;4266;5581;5025;14872;4910;0;12363;17273;65439;195.0;2016;True;36;5.593076923076923
7.0;Kertész Adrienn;1971;F3;HUN;Honvéd Sas-hegy SE;Budapest;F;315;4 / N2;4534;5121;6429;16084;4774;5491;7998;18263;4049;5836;5016;14901;4435;6773;5484;16692;65940;195.0;2016;True;45;5.635897435897436
33.0;Lévai Róbert Sándor;1982;M2;HUN;-;Mezőtúr;M;215;17 / F1;5368;5466;5920;16754;5450;5402;7300;18152;4455;5620;4782;14857;4716;0;11520;16236;65999;195.0;2016;True;34;5.640940170940171
34.0;Láng István;1957;M4;HUN;Gödi Futóklub;Göd (Alsógöd);M;30;8 / F3;5094;5221;6103;16418;5296;5291;7750;18337;4272;5611;4828;14711;4809;6677;5121;16607;66073;195.0;2016;True;59;5.647264957264958
8.0;Marton-Mlecsenkov Éva;1979;F2;HUN;Élményfutárok;Budapest;F;221;5 / N2;4724;4762;5287;14773;4959;5286;7823;18068;4162;0;10978;15140;4683;7914;5757;18354;66335;195.0;2016;True;37;5.669658119658119
35.0;Kollár Zoltán;1965;M4;HUN;Knorr-Bremse;Budapest;M;55;9 / F3;5403;5486;5791;16680;5380;5364;7341;18085;4551;5902;5025;15478;4831;6649;4814;16294;66537;195.0;2016;True;51;5.686923076923077
36.0;Ugróczky Barna;1971;M3;HUN;-;Perenye;M;108;10 / F2;5232;5427;5500;16159;5409;5343;7349;18101;4557;5889;4898;15344;4903;6880;5329;17112;66716;195.0;2016;True;45;5.702222222222223
37.0;Hoskó Roland;1976;M3;HUN;-;Budapest;M;255;18 / F1;5078;5488;6006;16572;5254;5464;7831;18549;4174;5666;5045;14885;4643;6726;5356;16725;66731;195.0;2016;True;40;5.703504273504274
38.0;Béki Zsolt;1977;M2;HUN;-;Budapest;M;278;19 / F1;5173;5119;5843;16135;5331;5348;7839;18518;4456;5695;4922;15073;4855;6774;5379;17008;66734;195.0;2016;True;39;5.703760683760684
39.0;Terpiak, Andrii;1962;M4;UKR;-;Tyachiv;M;196;10 / F3;4945;5161;5643;15749;5293;5562;7503;18358;4345;6019;5085;15449;4820;7264;5163;17247;66803;195.0;2016;True;54;5.70965811965812
40.0;Török Tamás;1992;M1;HUN;Pécsi testkultúra Közhasznú Egyesület;Budapest;M;251;20 / F1;4273;4832;6509;15614;4847;5461;9213;19521;4036;5527;5251;14814;4712;6865;5315;16892;66841;195.0;2016;True;24;5.7129059829059825
41.0;Geréd László Ifj.;1970;M3;HUN;-;Balatonalmádi;M;323;11 / F2;5106;5335;5602;16043;5558;5475;7582;18615;4524;5756;4857;15137;4859;6917;5508;17284;67079;195.0;2016;True;46;5.733247863247863
42.0;Földesi József;1957;M4;HUN;Tapolcai Honvéd SE;Tapolca;M;258;11 / F3;5174;5278;5461;15913;5504;5484;7539;18527;4580;5954;5009;15543;5044;6992;5068;17104;67087;195.0;2016;True;59;5.733931623931624
43.0;Fejes László;1973;M3;HUN;DK Team;Budapest;M;146;12 / F2;5199;5236;5383;15818;5349;5451;7317;18117;4445;0;10744;15189;5084;7417;5510;18011;67135;195.0;2016;True;43;5.738034188034188
9.0;Máténé Varju Edit;1971;F3;HUN;Ironteam SE;Székesfehérvár;F;328;6 / N2;5135;5495;5853;16483;5491;5494;7728;18713;4459;5858;5080;15397;4817;6775;4998;16590;67183;195.0;2016;True;45;5.742136752136752
44.0;Szász Péter;1977;M2;HUN;-;Székesfehérvár;M;184;21 / F1;4583;5127;6355;16065;4997;5211;7910;18118;4471;0;11196;15667;4887;7030;5562;17479;67329;195.0;2016;True;39;5.754615384615385
45.0;Köves Péter;1972;M3;HUN;Kanizsai Futóklub;Nagykanizsa;M;147;13 / F2;5163;5264;5574;16001;5426;5467;7967;18860;4454;5759;4771;14984;4974;7190;5290;17454;67299;195.0;2016;True;44;5.752051282051283
46.0;Szekeres Tibor;1966;M3;HUN;Kadarka Futóegyesület;Szekszárd;M;159;14 / F2;4875;5382;5999;16256;5453;5710;7742;18905;4481;5950;4949;15380;4812;6883;5179;16874;67415;195.0;2016;True;50;5.761965811965812
47.0;Szántó Árpád;1974;M3;HUN;-;Kecskemét;M;224;15 / F2;4744;5268;5133;15145;5976;6530;7200;19706;3934;6551;5414;15899;4552;7038;5103;16693;67443;195.0;2016;True;42;5.7643589743589745
48.0;Engelbrecht Zoltán ifj;1977;M2;HUN;Esztergomi Futóművek Amatőr Sportegyesület;Esztergom;M;170;22 / F1;4909;0;10870;15779;5330;5349;7950;18629;4624;5911;5391;15926;5083;6972;5214;17269;67603;195.0;2016;True;39;5.778034188034188
49.0;Séra István;1960;M4;HUN;Futóbolondok SE;Budapest;M;36;12 / F3;4623;5065;5901;15589;5162;5709;8344;19215;4245;5768;5015;15028;5019;7378;5432;17829;67661;195.0;2016;True;56;5.782991452991453
50.0;Csalló Gergő;1981;M2;HUN;-;Veszprém;M;160;23 / F1;5062;5434;5763;16259;5442;0;13442;18884;4553;6304;5174;16031;4927;6699;4940;16566;67740;195.0;2016;True;35;5.78974358974359
51.0;Navratil István;1961;M4;HUN;Flow SC;Gödöllő;M;214;13 / F3;5224;5669;5972;16865;5538;5629;7327;18494;4489;6112;4744;15345;5068;7097;5046;17211;67915;195.0;2016;True;55;5.804700854700855
52.0;Marosi Péter;1975;M3;HUN;IKEA FC;Baja;M;291;16 / F2;5419;0;10720;16139;5693;5437;7490;18620;4606;6001;5185;15792;4979;7164;5265;17408;67959;195.0;2016;True;41;5.808461538461539
53.0;Molnár Richárd;1965;M4;HUN;Budaörsi DSE;Budaörs;M;203;14 / F3;4813;5006;5465;15284;0;10678;9156;19834;4467;6059;4973;15499;4976;7244;5178;17398;68015;195.0;2016;True;51;5.813247863247863
54.0;Kovács Imre;1993;M1;HUN;Knorr-Bremse;Szigethalom;M;139;24 / F1;4927;5007;6177;16111;5376;5430;7627;18433;4545;6005;5098;15648;4934;0;13019;17953;68145;195.0;2016;True;23;5.824358974358974
55.0;Borsos József;1970;M3;HUN;-;Csolnok;M;151;17 / F2;5352;5526;5683;16561;5568;5593;7512;18673;4636;5985;5053;15674;4956;6947;5500;17403;68311;195.0;2016;True;46;5.838547008547009
10.0;Sebestyén Tímea;1978;F2;HUN;Honvéd Szondi György SE;Budapest;F;326;7 / N2;5178;5644;6152;16974;5847;5680;7573;19100;4173;5808;5219;15200;4839;6930;5279;17048;68322;195.0;2016;True;38;5.83948717948718
56.0;Kucsera Márton;1973;M3;HUN;MAFC;Budapest;M;231;18 / F2;5043;5159;5625;15827;5292;5456;7983;18731;4379;6063;5259;15701;5058;7491;5682;18231;68490;195.0;2016;True;43;5.8538461538461535
57.0;Heszberger Zalán;1973;M3;HUN;ELTE-BEAC Polythlon;Budapest;M;232;19 / F2;5395;5583;5716;16694;5723;5931;8397;20051;4603;0;10943;15546;4859;6651;5121;16631;68922;195.0;2016;True;43;5.890769230769231
58.0;Vanya Sándor;1964;M4;HUN;-;Szekszárd;M;201;15 / F3;5055;5247;5330;15632;5417;5535;9199;20151;4414;6032;5185;15631;4989;0;12626;17615;69029;195.0;2016;True;52;5.89991452991453
11.0;Pap-Csákvári Judit;1970;F3;HUN;-;Tiszaújváros;F;304;8 / N2;5471;5568;5734;16773;5696;6054;7604;19354;4642;5927;5121;15690;5159;7008;5150;17317;69134;195.0;2016;True;46;5.908888888888889
59.0;Beckmann, Michael;1969;M3;GER;TVE Weiher;Forst;M;408;20 / F2;5367;5374;5788;16529;5430;5611;8062;19103;4560;0;11193;15753;4949;7126;5783;17858;69243;195.0;2016;True;47;5.918205128205128
60.0;Andrási Csaba dr.;1972;M3;HUN;-;Nyíregyháza;M;210;21 / F2;4884;5292;6190;16366;5477;5715;8906;20098;4267;6054;5489;15810;4823;6959;5169;16951;69225;195.0;2016;True;44;5.916666666666667
61.0;Major Balázs;1974;M3;HUN;-;Budapest;M;192;22 / F2;5575;0;11366;16941;5661;5823;7743;19227;4626;5975;5095;15696;5135;7133;5440;17708;69572;195.0;2016;True;42;5.946324786324786
62.0;Szabó Zoltán Dr.;1958;M4;HUN;-;Dunaújváros;M;193;16 / F3;5424;6202;5665;17291;5488;5629;8181;19298;4470;5827;5098;15395;4820;7225;5619;17664;69648;195.0;2016;True;58;5.952820512820512
63.0;Vízer Dániel;1981;M2;HUN;Ironteam SE;Székesfehérvár;M;103;25 / F1;5393;5603;5904;16900;5718;5693;8066;19477;4655;5921;5244;15820;5126;0;12340;17466;69663;195.0;2016;True;35;5.9541025641025636
64.0;Pálfi László ifj;1977;M2;HUN;Tárnok Sprint Egyesület;Budapest;M;204;26 / F1;5533;5779;6389;17701;5764;5689;7912;19365;4660;6049;4932;15641;5129;7065;5187;17381;70088;195.0;2016;True;39;5.990427350427351
65.0;Bognár Viktor dr.;1971;M3;HUN;Gödi Futóklub;Göd (Alsógöd);M;158;23 / F2;5348;5533;6485;17366;5531;5628;8042;19201;4482;6103;5316;15901;5067;7155;5476;17698;70166;195.0;2016;True;45;5.9970940170940175
66.0;Acsádi Lajos;1972;M3;HUN;-;Nádudvar;M;128;24 / F2;5538;5654;5977;17169;5710;5665;7930;19305;4613;5986;5250;15849;5125;7201;5727;18053;70376;195.0;2016;True;44;6.015042735042735
67.0;Vadász Attila;1964;M4;HUN;Tapolca Honvéd SE;Szigliget;M;313;17 / F3;4768;5163;6299;16230;5536;5695;7842;19073;4535;6413;5245;16193;5173;8486;5299;18958;70454;195.0;2016;True;52;6.021709401709402
68.0;Sutyinszky Tamás;1972;M3;HUN;-;Budapest;M;135;25 / F2;5233;5486;5842;16561;5413;5428;8128;18969;4579;6162;5509;16250;5046;7683;6002;18731;70511;195.0;2016;True;44;6.026581196581197
69.0;Fender, Norbert;1959;M4;GER;-;Rutesheim;M;467;18 / F3;5524;0;11448;16972;5383;5328;7923;18634;4771;6339;5587;16697;4885;7443;5979;18307;70610;195.0;2016;True;57;6.035042735042735
70.0;Horváth Péter;1968;M3;HUN;-;Szombathely;M;331;26 / F2;5215;5655;6066;16936;5562;5695;8190;19447;4687;6264;5215;16166;5215;0;12913;18128;70677;195.0;2016;True;48;6.040769230769231
12.0;Barna Anikó;1987;F2;HUN;-;Bagnolet;F;169;4 / N1;5422;5736;5904;17062;5901;6047;8088;20036;4853;6133;5367;16353;5035;6903;5351;17289;70740;195.0;2016;True;29;6.046153846153846
71.0;Hugyecz Attila;1969;M3;HUN;Gödi Futóklub;Kosd;M;274;27 / F2;5422;5690;6186;17298;5887;6099;8693;20679;4632;6218;4953;15803;5007;7008;5003;17018;70798;195.0;2016;True;47;6.051111111111111
72.0;Czaltig Zsolt;1974;M3;HUN;-;Lajoskomárom;M;118;28 / F2;5417;5651;6081;17149;5806;5945;8227;19978;4680;6155;5201;16036;5342;7077;5592;18011;71174;195.0;2016;True;42;6.0832478632478635
73.0;Hajdú Péter;1954;M5;HUN;Runberries;Budapest;M;138;19 / F3;5197;5502;5903;16602;5163;5294;7952;18409;4381;6009;5792;16182;5184;8204;6578;19966;71159;195.0;2016;True;62;6.081965811965812
74.0;Garami Csongor;1968;M3;HUN;-;Törökbálint;M;110;29 / F2;5005;0;11573;16578;5391;5534;8250;19175;4454;6379;5957;16790;4998;7436;6401;18835;71378;195.0;2016;True;48;6.100683760683761
75.0;Jakubocy, Igor;1974;M3;SVK;-;Pezinok;M;420;30 / F2;5556;5749;6332;17637;5729;5644;8022;19395;4600;6104;5253;15957;5130;7284;6121;18535;71524;195.0;2016;True;42;6.113162393162393
76.0;Füredi Sándor;1970;M3;HUN;Pénzügyőr SE;Vác;M;264;31 / F2;4877;5270;5829;15976;5373;6058;8571;20002;4513;6693;6084;17290;5068;7681;5789;18538;71806;195.0;2016;True;46;6.137264957264957
77.0;Sipos Sándor;1957;M4;HUN;HASE;Budapest;M;261;20 / F3;5129;5324;5575;16028;5473;5703;8502;19678;4531;6208;5759;16498;5571;7881;6115;19567;71771;195.0;2016;True;59;6.134273504273504
78.0;Simon Péter;1965;M4;HUN;-;Budapest;M;306;21 / F3;4939;5260;6044;16243;5515;5812;8407;19734;4648;6443;5615;16706;5242;7903;6717;19862;72545;195.0;2016;True;51;6.20042735042735
13.0;Bartucz Borbála;1979;F2;HUN;SUHANJ!;Budapest;F;295;9 / N2;5527;6036;5994;17557;5863;5901;7852;19616;4764;6551;5477;16792;5104;7606;5959;18669;72634;195.0;2016;True;37;6.208034188034188
79.0;Kováts Mihály;1973;M3;HUN;-;Budapest;M;294;32 / F2;5529;6039;5988;17556;5870;5898;7850;19618;4771;6552;5475;16798;5106;7607;5954;18667;72639;195.0;2016;True;43;6.208461538461539
80.0;Simon Zoltán;1970;M3;HUN;-;Solymár;M;37;33 / F2;5307;5744;6652;17703;5854;5811;8375;20040;4953;6386;5347;16686;5416;7337;5490;18243;72672;195.0;2016;True;46;6.211282051282051
81.0;Bíró Géza;1967;M3;HUN;-;Balatonkeresztúr;M;319;34 / F2;5335;0;11530;16865;5815;0;13922;19737;4914;6520;5701;17135;5449;7704;5915;19068;72805;195.0;2016;True;49;6.222649572649573
14.0;Hugyecz Attiláné;1970;F3;HUN;Gödi Futóklub;Kosd;F;275;10 / N2;5539;5943;6036;17518;5953;6045;8425;20423;4855;6428;5456;16739;5096;7414;5614;18124;72804;195.0;2016;True;46;6.222564102564103
15.0;Bonczók Tünde;1974;F3;HUN;-;Siófok;F;197;11 / N2;5529;6094;6155;17778;5607;5781;7822;19210;4611;6383;5382;16376;5094;7944;6633;19671;73035;195.0;2016;True;42;6.242307692307692
82.0;Farkas László;1967;M3;HUN;Futóbolondok SE;Budapest;M;20;35 / F2;5096;5465;6200;16761;5578;0;14688;20266;5002;0;12771;17773;5413;7348;5481;18242;73042;195.0;2016;True;49;6.242905982905983
83.0;Kurpé László dr.;1970;M3;HUN;Triton Triatlon Club Hatvan;Hatvan;M;271;36 / F2;5671;6286;5991;17948;5826;5719;8757;20302;4433;6435;5238;16106;5853;7754;5256;18863;73219;195.0;2016;True;46;6.258034188034188
16.0;Fekete Krisztina;1973;F3;HUN;Minden-kor Női Sportegyesület;Budapest;F;259;12 / N2;5705;5796;6105;17606;5830;5869;7920;19619;4856;6451;5644;16951;5432;0;13671;19103;73279;195.0;2016;True;43;6.263162393162393
84.0;Kőrösi Koppány dr.;1971;M3;HUN;Kilóméter gyüjtők;Budapest;M;105;37 / F2;5732;5715;6373;17820;5732;5772;9498;21002;4829;6467;5370;16666;5225;7474;5621;18320;73808;195.0;2016;True;45;6.308376068376069
85.0;Kovács Ferenc dr.;1976;M3;HUN;-;Budapest;M;182;38 / F2;5769;6040;6688;18497;5837;5921;7854;19612;4778;6690;5831;17299;5206;7620;5871;18697;74105;195.0;2016;True;40;6.3337606837606835
86.0;Petró Viktor;1984;M2;HUN;SUHANJ!;Budapest;M;164;27 / F1;5284;5540;6742;17566;5945;6354;7887;20186;5196;7331;5056;17583;5555;8308;5084;18947;74282;195.0;2016;True;32;6.348888888888888
87.0;Veres, Sandor;1962;M4;GER;AYCM Racing Team;Chemnitz;M;195;22 / F3;5538;5966;5579;17083;6535;0;14215;20750;5333;0;12231;17564;5706;7651;5726;19083;74480;195.0;2016;True;54;6.365811965811965
88.0;Pataky Ferenc;1967;M3;HUN;-;Dunaharaszti;M;309;39 / F2;5389;5785;6750;17924;5901;6421;9377;21699;4776;6387;5457;16620;5344;7337;5577;18258;74501;195.0;2016;True;49;6.3676068376068375
17.0;Schneller Erika;1968;F3;HUN;Iron Team;Szentendre;F;101;13 / N2;5766;6013;6163;17942;6099;6214;8476;20789;5021;6679;5596;17296;5357;7641;5879;18877;74904;195.0;2016;True;48;6.402051282051283
18.0;Milus Ilona Tünde;1973;F3;HUN;Futóbarátok - Nike Futóklub Győr;Győr;F;268;14 / N2;5767;6016;6159;17942;6099;6219;8480;20798;5007;6693;5595;17295;5346;7647;5882;18875;74910;195.0;2016;True;43;6.402564102564103
89.0;Lukovics Béla;1953;M5;HUN;Békéscsabai AC;Békéscsaba;M;58;23 / F3;5511;6042;6681;18234;5750;0;14769;20519;5581;7757;5148;18486;5472;0;12572;18044;75283;195.0;2016;True;63;6.434444444444445
90.0;Somogyi Zsolt;1978;M2;HUN;-;Ráckeresztúr;M;314;28 / F1;5145;5912;6233;17290;5311;5879;8910;20100;4435;6604;6693;17732;5740;8152;6417;20309;75431;195.0;2016;True;38;6.447094017094018
91.0;Halász Péter;1973;M3;HUN;-;Wien;M;114;40 / F2;0;0;17637;17637;5877;5943;9176;20996;4761;6283;5894;16938;5739;7977;6166;19882;75453;195.0;2016;True;43;6.4489743589743584
19.0;Reiman Katalin;1960;F4;HUN;-;Budapest;F;254;1 / N3;5805;6289;6449;18543;5901;6416;8422;20739;5108;0;12018;17126;5645;7773;5703;19121;75529;195.0;2016;True;56;6.455470085470085
92.0;Aschenbrenner, Florian;1988;M2;GER;Kuhalm Runnings;Drachselsried;M;416;29 / F1;4682;5257;6589;16528;5518;5705;9314;20537;4860;6545;6658;18063;5248;7756;7454;20458;75586;195.0;2016;True;28;6.46034188034188
93.0;Krabácz Miklós;1959;M4;HUN;Buda Fitness;Budapest;M;176;24 / F3;5410;5586;5971;16967;5742;6202;9710;21654;4845;7315;6185;18345;5499;8214;5459;19172;76138;195.0;2016;True;57;6.507521367521368
94.0;Bödő Imre;1980;M2;HUN;-;Kőszeg;M;227;30 / F1;5070;5677;6567;17314;5486;5727;8106;19319;4986;0;13128;18114;5400;8639;7284;21323;76070;195.0;2016;True;36;6.501709401709402
95.0;Árgyelán Krisztián;1976;M3;HUN;Fősör FC;Kétegyháza;M;150;31 / F1;5693;0;12299;17992;5974;6348;8495;20817;5169;7045;5854;18068;5695;7942;5790;19427;76304;195.0;2016;True;40;6.521709401709402
20.0;Csúzdi-Hack Zsanett;1984;F2;HUN;-;Nyergesújfalu;F;137;5 / N1;5227;5919;6370;17516;5465;6258;9303;21026;5212;6910;6308;18430;5421;8205;5846;19472;76444;195.0;2016;True;32;6.533675213675213
96.0;Taucher, Norbert;1971;M3;AUT;-;Gleisdorf;M;483;41 / F2;6034;6192;6232;18458;5941;6525;8657;21123;5050;6959;5796;17805;5656;8081;5487;19224;76610;195.0;2016;True;45;6.547863247863248
21.0;Csathó Lilla;1991;F1;HUN;DVSI;Dunaújváros;F;300;6 / N1;6048;6172;6427;18647;6243;6108;8547;20898;5246;6931;5755;17932;5538;8000;5927;19465;76942;195.0;2016;True;25;6.576239316239316
97.0;Bakó Attila;1971;M3;HUN;Győri FutOltók;Kunsziget;M;299;42 / F2;5744;6096;7727;19567;6085;6218;8589;20892;5136;6680;5594;17410;5522;7776;5848;19146;77015;195.0;2016;True;45;6.582478632478632
98.0;Kovács Balázs;1977;M2;HUN;-;Budapest;M;207;32 / F1;6142;6228;6278;18648;6431;6247;8392;21070;5157;6869;5729;17755;5707;7905;6020;19632;77105;195.0;2016;True;39;6.59017094017094
99.0;Nelsen, Ferdinand;1950;M5;BEL;-;Bonheiden;M;424;25 / F3;5471;6479;6506;18456;5793;6456;8567;20816;4823;7028;5828;17679;5417;0;14795;20212;77163;195.0;2016;True;66;6.595128205128205
100.0;Kreszta Zoltán;1970;M3;HUN;-;Budapest;M;11;43 / F2;5248;5517;7325;18090;5784;6538;10554;22876;4731;6414;5650;16795;5234;7951;6434;19619;77380;195.0;2016;True;46;6.613675213675214
22.0;Szilágyi Éva;1969;F3;HUN;NYIFU SE;Nyíregyháza;F;172;15 / N2;5403;5865;6429;17697;5979;6145;9095;21219;4882;7056;5981;17919;5496;8255;6953;20704;77539;195.0;2016;True;47;6.627264957264957
23.0;Makkai Éva;1975;F3;HUN;NYIFU SE;Nyíregyháza;F;174;16 / N2;5407;5865;6424;17696;5982;6149;9096;21227;4877;7053;5984;17914;5496;8264;6944;20704;77541;195.0;2016;True;41;6.627435897435897
101.0;Moós Gergely;1978;M2;HUN;DK Team;Budapest;M;145;33 / F1;5886;6429;6530;18845;6141;5998;8671;20810;5135;7267;6241;18643;5738;8095;5472;19305;77603;195.0;2016;True;38;6.632735042735043
24.0;Szabó Krisztina dr.;1971;F3;HUN;Sportzoona;Budapest;F;288;17 / N2;5348;6590;5931;17869;5839;6341;8873;21053;4909;7075;6022;18006;5547;8576;6611;20734;77662;195.0;2016;True;45;6.637777777777777
102.0;Prekopp Péter Dr.;1978;M2;HUN;AVSE;Budapest;M;143;34 / F1;5417;5982;6334;17733;6051;6308;8780;21139;5262;6999;6050;18311;5775;8417;6311;20503;77686;195.0;2016;True;38;6.63982905982906
103.0;Szabó Balázs dr.;1970;M3;HUN;Iron Team;Budapest;M;119;44 / F2;5416;5975;6341;17732;6054;6304;8793;21151;5261;7001;6049;18311;5776;8368;6356;20500;77694;195.0;2016;True;46;6.6405128205128205
104.0;Szőke Zoltán;1972;M3;HUN;-;Tiszavasvári;M;228;45 / F2;6115;6337;6765;19217;6559;6522;8879;21960;5178;6804;5674;17656;5367;7650;5928;18945;77778;195.0;2016;True;44;6.647692307692307
105.0;Pivnyik László;1976;M3;HUN;-;Nyíregyháza;M;168;35 / F1;5695;5718;6229;17642;5644;6598;8676;20918;4687;6449;6276;17412;5671;8938;7372;21981;77953;195.0;2016;True;40;6.662649572649573
25.0;Györgyi Katalin;1968;F3;HUN;Fut a Haraszti;Dunaharaszti;F;226;18 / N2;5686;5967;6868;18521;6054;6789;9319;22162;5034;7062;5459;17555;6061;7603;6153;19817;78055;195.0;2016;True;48;6.671367521367522
106.0;Kalman Kallo Mr.;1975;M3;HUN;-;Den Haag;M;149;46 / F2;6118;6241;6432;18791;6305;0;14836;21141;5179;7221;6069;18469;5593;7928;6133;19654;78055;195.0;2016;True;41;6.671367521367522
26.0;Menz Judit Ms.;1972;F3;HUN;ETSV LAUDA;Lauda;F;230;19 / N2;6003;0;12537;18540;6414;6619;8490;21523;5286;6968;5961;18215;5713;8048;6066;19827;78105;195.0;2016;True;44;6.675641025641026
107.0;Vass János;1967;M3;HUN;Pénzügyőr SE;Budapest;M;303;47 / F2;5536;6068;6128;17732;5918;0;15850;21768;5192;0;13169;18361;5517;8327;6628;20472;78333;195.0;2016;True;49;6.695128205128205
108.0;Kóder Gábor;1981;M2;HUN;Újpalota SC;Dunakeszi;M;318;36 / F1;5486;5816;6377;17679;5907;6609;9978;22494;4949;0;13876;18825;5865;7962;5553;19380;78378;195.0;2016;True;35;6.6989743589743584
27.0;Fejér Zsuzsa;1971;F3;HUN;-;Budapest;F;154;20 / N2;5684;6256;6271;18211;6079;6318;8301;20698;5468;7388;5607;18463;6072;8958;6052;21082;78454;195.0;2016;True;45;6.705470085470085
28.0;Szalay Tünde;1982;F2;HUN;IKEA FC;Budapest;F;292;7 / N1;5732;6688;7147;19567;5981;6092;9137;21210;5184;7223;6067;18474;5594;7930;6133;19657;78908;195.0;2016;True;34;6.7442735042735045
109.0;Vasas Levente;1981;M2;HUN;-;Kecskemét;M;277;37 / F1;5176;6370;7385;18931;5597;6732;8610;20939;4797;6540;7135;18472;5481;8185;6806;20472;78814;195.0;2016;True;35;6.736239316239316
110.0;Szigeti Attila;1970;M3;HUN;-;Siófok;M;109;48 / F2;6185;6707;6819;19711;6468;6889;8930;22287;5157;6794;5874;17825;5580;7628;5816;19024;78847;195.0;2016;True;46;6.739059829059829
111.0;Béry Norbert;1970;M3;HUN;-;Söpte;M;183;49 / F2;5550;6165;6659;18374;5699;6420;9692;21811;4662;7009;6552;18223;5266;8795;6982;21043;79451;195.0;2016;True;46;6.790683760683761
29.0;Lindholm Inga, Sarah;1961;F4;SWE;Vallentuna FK;Vallentuna;F;482;2 / N3;5981;6455;6522;18958;5678;6278;8727;20683;4964;6974;6178;18116;6096;8673;6873;21642;79399;195.0;2016;True;55;6.786239316239316
112.0;Fievet, Freddie;1956;M5;FRA;-;LA SELLE EN HERMOY;M;425;26 / F3;5867;6516;7167;19550;6144;6237;10132;22513;4741;6665;6336;17742;5524;7963;6518;20005;79810;195.0;2016;True;60;6.821367521367522
113.0;Paraniak, Jan;1950;M5;SWE;Team Skavsärer IF;Huddinge;M;469;27 / F3;5399;0;12695;18094;5618;6622;10052;22292;5207;7307;6243;18757;5632;8525;6563;20720;79863;195.0;2016;True;66;6.825897435897436
30.0;Országné Faragó Éva;1966;F3;HUN;TRIA-TÚRA SE Kecskemét;Kecskemét;F;293;21 / N2;5440;0;13501;18941;5884;6481;9304;21669;5030;7840;5998;18868;5661;8548;6283;20492;79970;195.0;2016;True;50;6.835042735042735
114.0;Szlaukó Gábor;1979;M2;HUN;-;Budapest;M;286;38 / F1;5763;6112;7338;19213;6474;6956;9372;22802;5275;6864;5825;17964;5980;8205;6057;20242;80221;195.0;2016;True;37;6.8564957264957265
31.0;Baráth Anette Lora;1971;F3;HUN;-;Debrecen;F;233;22 / N2;5475;0;12447;17922;5850;6564;9286;21700;5247;0;13963;19210;5841;8643;6919;21403;80235;195.0;2016;True;45;6.857692307692307
115.0;Ridly István Attila;1981;M2;HUN;Négy Égtáj SE;Nyergesújfalu;M;132;39 / F1;5650;6059;7819;19528;6310;6672;9682;22664;5212;7171;5919;18302;5581;8268;6166;20015;80509;195.0;2016;True;35;6.881111111111111
32.0;Ölveczki Kármen;1971;F3;HUN;-;Budapest;F;157;23 / N2;5351;6797;8463;20611;5833;6336;8876;21045;4909;7067;6028;18004;5550;8573;6617;20740;80400;195.0;2016;True;45;6.871794871794871
116.0;Tóth István;1978;M2;HUN;-;Budapest;M;198;40 / F1;5834;6459;6907;19200;6567;6819;9173;22559;5288;7223;6142;18653;5688;8598;6090;20376;80788;195.0;2016;True;38;6.9049572649572655
33.0;Olaj, Itta;1968;F3;AUT;LG Mauerweg Berlin e.V.;Lindow;F;412;24 / N2;6153;6510;6647;19310;6598;6651;9211;22460;5364;7177;5618;18159;5789;8038;7201;21028;80957;195.0;2016;True;48;6.9194017094017095
117.0;Rudolf József dr.;1970;M3;HUN;-;Budapest;M;115;50 / F2;5661;6483;7250;19394;6145;6803;9468;22416;5199;7403;6073;18675;5624;8769;6252;20645;81130;195.0;2016;True;46;6.934188034188034
34.0;Kovács Nóra dr.;1970;F3;HUN;-;Budapest;F;116;25 / N2;5663;6273;7457;19393;6177;6790;9457;22424;5160;7429;6083;18672;5617;8769;6255;20641;81130;195.0;2016;True;46;6.934188034188034
118.0;Preil József;1978;M2;HUN;-;Székesfehérvár;M;222;41 / F1;5743;6062;5966;17771;6392;6653;9447;22492;5366;7234;6450;19050;6397;9473;6554;22424;81737;195.0;2016;True;38;6.986068376068376
119.0;Körmöczy Zoltán;1971;M3;HUN;Dabasi SE;Vecsés;M;194;51 / F2;5624;6039;7791;19454;6540;6998;10488;24026;5210;7188;5588;17986;5708;8256;6061;20025;81491;195.0;2016;True;45;6.9650427350427355
35.0;Möhr, Andrea;1965;F3;GER;LAC Berlin;Berlin;F;406;3 / N3;6467;7000;7164;20631;6744;6919;9517;23180;5505;7110;5843;18458;5701;7854;5778;19333;81602;195.0;2016;True;51;6.974529914529914
36.0;Fender, Birgit;1963;F3;GER;100marathon42.de;Rutesheim;F;466;4 / N3;6044;6702;7241;19987;6664;6925;9188;22777;5486;7517;6336;19339;5699;7960;5975;19634;81737;195.0;2016;True;53;6.986068376068376
37.0;Sebestyén Linda;1980;F2;HUN;SZUFLA;Budapest;F;180;26 / N2;5985;0;12603;18588;6305;6721;8631;21657;5344;7476;6099;18919;6009;9676;6990;22675;81839;195.0;2016;True;36;6.9947863247863244
120.0;Oel, Gottfried;1959;M4;GER;LLC Marathon Regensburg;Bruchsal;M;410;28 / F3;5366;6018;7531;18915;6532;6573;10072;23177;5229;7351;6657;19237;5712;8158;6703;20573;81902;195.0;2016;True;57;7.00017094017094
121.0;Jánosi Kornél dr.;1964;M4;HUN;Buda Fitness;Szentendre;M;163;29 / F3;5988;6299;6960;19247;6446;6876;9798;23120;5217;7200;6377;18794;5820;8764;6610;21194;82355;195.0;2016;True;52;7.038888888888889
122.0;Péter Ferenc;1971;M3;HUN;-;Szeged;M;206;52 / F2;5620;6226;7706;19552;6197;6670;9825;22692;5179;7201;6308;18688;5675;8898;7286;21859;82791;195.0;2016;True;45;7.076153846153845
123.0;Lenkei Gábor;1976;M3;HUN;Süssön Rád a Nap;Budapest;M;287;53 / F2;5796;7253;7129;20178;6424;7091;9959;23474;5471;7136;5911;18518;6163;0;14374;20537;82707;195.0;2016;True;40;7.068974358974359
124.0;Pace, Antoine;1965;M4;MLT;-;Naxxar;M;414;30 / F3;6431;6703;6852;19986;6606;6574;9074;22254;5461;7145;6178;18784;6292;8719;6860;21871;82895;195.0;2016;True;51;7.085042735042735
125.0;Von Uleniecki, Alexander;1968;M3;GER;LG Mauerweg Berlin e.V.;Lindow (Mark);M;413;54 / F2;6151;6515;6646;19312;6598;0;15858;22456;5366;0;13225;18591;6348;9483;7277;23108;83467;195.0;2016;True;48;7.133931623931623
126.0;Mats, Dänsel;1957;M4;SWE;Team Sweden;Alta;M;478;31 / F3;6462;6666;6927;20055;6625;6555;9675;22855;5480;7341;6259;19080;6070;8702;6845;21617;83607;195.0;2016;True;59;7.145897435897436
127.0;Bertil, Lundell;1965;M4;SWE;IF Linnea;Stockholm;M;479;32 / F3;6460;6667;6929;20056;6621;6550;9681;22852;5476;7308;6291;19075;6099;8677;6871;21647;83630;195.0;2016;True;51;7.147863247863247
128.0;Szerencsés Tamás ifj.;1975;M3;HUN;Esztergomi Futóművek;Esztergom;M;256;55 / F2;6157;6838;7290;20285;6190;7012;9726;22928;5285;7159;6011;18455;6007;8854;7316;22177;83845;195.0;2016;True;41;7.1662393162393165
129.0;Kakuk Bence;1987;M2;HUN;Pénzügyőr SE;Dunakeszi;M;265;42 / F1;5214;5594;7024;17832;6265;6910;10952;24127;5206;0;14341;19547;6278;9144;6997;22419;83925;195.0;2016;True;29;7.173076923076923
130.0;Waldmann, Wolfgang;1961;M4;AUT;LAC Langenhagen;Hanover;M;407;33 / F3;5999;0;13368;19367;6452;6507;8755;21714;5258;7449;6621;19328;6425;9646;7774;23845;84254;195.0;2016;True;55;7.201196581196581
131.0;Szlaukó Róbert;1979;M2;HUN;Süssön Rád a Nap;Budapest;M;285;43 / F1;5783;7264;7429;20476;6536;6980;9787;23303;0;12841;6076;18917;6156;8857;6800;21813;84509;195.0;2016;True;37;7.222991452991453
132.0;Porstner, Thomas Dr.;1963;M4;GER;GutsMuthsRennsteiglaufverein;Bad Düben;M;417;34 / F3;0;0;18713;18713;6302;6432;11019;23753;5286;7682;6726;19694;6262;9288;7339;22889;85049;195.0;2016;True;53;7.2691452991453
38.0;Reich Orsolya;1981;F2;HUN;-;Tököl;F;130;8 / N1;6430;7058;7244;20732;6874;6770;8786;22430;5492;7093;6004;18589;6555;9472;7008;23035;84786;195.0;2016;True;35;7.246666666666666
39.0;Pistyur-Kocsis Ágnes;1982;F2;HUN;-;Esztergom-kertváros;F;144;9 / N1;6099;6592;7229;19920;6247;6651;9763;22661;5354;7682;6708;19744;6209;9460;7799;23468;85793;195.0;2016;True;34;7.3327350427350435
133.0;Szabó Zoltán;1968;M3;HUN;SZVISE Atlétika és Triatlon;Százhalombatta;M;225;56 / F2;5516;7089;7582;20187;5840;7608;10883;24331;5582;7961;6724;20267;0;14855;6267;21122;85907;195.0;2016;True;48;7.342478632478632
134.0;Hack Román Antal;1974;M3;HUN;Hack-i mer az nyer;Nyergesújfalu;M;25;57 / F2;5988;6302;6958;19248;6449;6878;9769;23096;5216;7726;6500;19442;6259;10358;7966;24583;86369;195.0;2016;True;42;7.381965811965812
135.0;Künstner, Jörn;1970;M3;GER;LG Mauerweg Berlin e.V.;Berlin;M;418;58 / F2;6465;6997;7169;20631;6743;6920;9521;23184;5603;7628;6658;19889;6419;9247;7492;23158;86862;195.0;2016;True;46;7.424102564102564
40.0;Schmitt, Sonja;1975;F3;GER;LG Mauerweg Berlin e.V.;Berlin;F;419;27 / N2;6464;7005;7165;20634;6737;6924;9519;23180;5613;7625;6662;19900;6414;9319;7417;23150;86864;195.0;2016;True;41;7.424273504273504
136.0;Holové Péter;1983;M2;HUN;Knorr-Bremse;Budapest;M;141;44 / F1;6577;7131;7328;21036;6770;6888;9635;23293;5476;7602;6455;19533;6597;9555;7077;23229;87091;195.0;2016;True;33;7.443675213675213
137.0;Bars Tamás;1983;M2;HUN;-;Budapest;M;216;45 / F1;6111;7179;7842;21132;7166;0;16982;24148;5693;7845;6337;19875;7217;7971;6938;22126;87281;195.0;2016;True;33;7.45991452991453
138.0;Heitfeldt, Ulrich;1957;M4;GER;-;Hohenhameln;M;411;35 / F3;5496;6277;7537;19310;6628;7691;11340;25659;5777;8486;7338;21601;5713;8470;6993;21176;87746;195.0;2016;True;59;7.49965811965812
41.0;Schramm, Kati;1967;F3;GER;KATIS PACE TEAM;Leonberg;F;403;28 / N2;5986;6685;7060;19731;6663;7105;10671;24439;5495;0;15125;20620;6631;8998;7602;23231;88021;195.0;2016;True;49;7.523162393162393
139.0;Blücher, Tord;1958;M4;SWE;Storädalens LDK;Stora;M;472;36 / F3;5979;6451;6527;18957;6819;7279;10768;24866;5600;8429;7076;21105;6372;9478;7530;23380;88308;195.0;2016;True;58;7.547692307692308
42.0;Valter Éva;1972;F3;HUN;-;Fót;F;185;29 / N2;5853;6669;7788;20310;6325;7135;10326;23786;5429;8286;7288;21003;6639;9668;7989;24296;89395;195.0;2016;True;44;7.640598290598291
140.0;Nilsson, Jörgen;1950;M5;SWE;Vi som springer;Hisingkärra;M;473;37 / F3;6201;7076;7686;20963;6832;7278;10768;24878;5607;8413;7087;21107;6365;9478;7541;23384;90332;195.0;2016;True;66;7.720683760683761
43.0;Broman, Kristina;1978;F2;SWE;Borlange LK;Borlange;F;476;30 / N2;6205;7067;7692;20964;6823;7296;10750;24869;5613;8415;7093;21121;6386;9249;7764;23399;90353;195.0;2016;True;38;7.722478632478633
141.0;Wikström, Staffan;1955;M5;SWE;Vattudalens LDK;Strömsund;M;474;38 / F3;6235;7046;7696;20977;6831;7514;10466;24811;5603;8085;6967;20655;6611;9838;7612;24061;90504;195.0;2016;True;61;7.735384615384616
44.0;Nielsen, Sille Viktoria Pia Ehlert;1982;F2;DEN;-;Viborg;F;421;10 / N1;6320;7124;7869;21313;7440;7336;9855;24631;6051;8712;7503;22266;6658;9489;6281;22428;90638;195.0;2016;True;34;7.746837606837607
142.0;Ajkay Antal;1950;M5;HUN;Sárvár Kinizsi SE;Budapest;M;102;39 / F3;6470;7333;7723;21526;7489;0;18377;25866;5716;0;14697;20413;6455;0;16752;23207;91012;195.0;2016;True;66;7.7788034188034185
45.0;Brevákné Kiss Edit;1962;F3;HUN;Futakeszi;Dunakeszi;F;257;5 / N3;6559;7503;7153;21215;6684;7650;10768;25102;5720;8521;6452;20693;6707;10257;8121;25085;92095;195.0;2016;True;54;7.871367521367522
143.0;Sándor Miklós;1975;M3;HUN;-;Szolnok;M;199;59 / F2;5589;6199;8010;19798;6511;7670;10525;24706;5722;8744;8181;22647;6590;10468;8832;25890;93041;195.0;2016;True;41;7.952222222222223
46.0;Annika, Rosengren;1958;F4;SWE;Team Stockholm Marathon;Stockholm;F;477;6 / N3;6478;7236;7553;21267;7016;7741;11192;25949;5798;8510;7735;22043;6687;10726;8577;25990;95249;195.0;2016;True;58;8.140940170940171
999.0;Süle Krisztián Péter;1974;M3;HUN;-;Budapest;M;186;;4935;5558;8103;18596;0;0;0;0;0;0;0;0;0;0;0;0;18596;48.0;2016;False;42;6.456944444444445
999.0;Mészáros László;1978;M2;HUN;Futóbarátok Egyesület;Budapest;M;212;;4211;4422;4741;13374;4755;4848;7101;16704;4151;5589;5076;14816;0;0;0;0;44894;146.0;2016;False;38;5.124885844748858
999.0;Wiesler, Peter;1955;M5;SWE;Team Skavsärer IF;Akersberga;M;471;;6873;0;0;6873;0;0;0;0;0;0;0;0;6384;0;0;6384;13257;30.0;2016;False;61;7.364999999999999
999.0;Kovács Ákos Flórián;1975;M3;HUN;DTSE;Dunaújváros;M;290;;5424;5643;6763;17830;5414;5658;7858;18930;4260;0;0;4260;0;0;0;0;41020;114.0;2016;False;41;5.997076023391813
999.0;Csákány Krisztina;1971;F3;HUN;Futóbarátok Egyyesület Győr;Győrújbarát;F;162;;0;0;0;0;6091;6222;8584;20897;0;0;0;0;0;0;0;0;20897;52.0;2016;False;45;6.697756410256411
999.0;Péntek Zoltán dr.;1975;M3;HUN;TovaFutók SE;Ajka;M;223;;5793;6622;7381;19796;6458;7636;11078;25172;0;0;0;0;0;0;0;0;44968;101.0;2016;False;41;7.420462046204621
999.0;Iváncsics Zsolt;1968;M3;HUN;EMU;Orosháza;M;327;;5928;6814;8316;21058;0;0;0;0;5163;7909;7776;20848;6286;8849;6898;22033;63939;142.0;2016;False;48;7.504577464788733
999.0;Krivács Henrietta;1983;F2;HUN;Pénzügyőr SE;Nyírbátor;F;301;;5627;6029;7255;18911;0;0;0;0;0;0;0;0;0;0;0;0;18911;48.0;2016;False;33;6.566319444444445
999.0;Karlovitz Máté;1975;M3;HUN;-;Budapest;M;330;;5499;5943;6873;18315;5783;6368;9703;21854;0;0;0;0;6703;0;0;6703;46872;115.0;2016;False;41;6.79304347826087
999.0;Steszli Balázs;1979;M2;HUN;Élménykülönítmény;Herend;M;219;;4989;5334;0;10323;5633;0;14389;20022;4665;6167;5749;16581;5084;7592;6225;18901;65827;179.0;2016;False;37;6.129143389199254
999.0;Csecsetka Dániel;1985;M2;HUN;-;Dunakeszi;M;175;;5782;6738;7514;20034;0;0;0;0;5116;7160;6271;18547;6054;8709;6680;21443;60024;142.0;2016;False;31;7.045070422535211
999.0;Bárány Nóra;1980;F2;HUN;Tapolca Honvéd SE;Tapolca;F;311;;5166;5547;6142;16855;5912;6255;9648;21815;0;0;0;0;0;0;0;0;38670;101.0;2016;False;36;6.381188118811881
999.0;Buza Norbert;1979;M2;HUN;Pulzus Szeged Futóklub;Szeged;M;280;;5693;6799;8526;21018;6383;7150;11325;24858;0;0;0;0;6094;9292;7735;23121;68997;150.0;2016;False;37;7.666333333333333
999.0;Gábriel Nikolett;1979;F2;HUN;-;Budapest;F;121;;6329;7381;7814;21524;0;0;0;0;0;0;0;0;0;0;0;0;21524;48.0;2016;False;37;7.473611111111111
999.0;Vakhal Norbert;1979;M2;HUN;Honvéd Szondi György SE;Székesfehérvár;M;325;;4388;4424;4465;13277;4477;4577;0;9054;0;0;0;0;0;0;0;0;22331;79.0;2016;False;37;4.7111814345991565
999.0;Pfeffer, Martin;1989;M1;GER;Kuhalm Runnings;Zachenberg;M;415;;4681;5256;6589;16526;5525;5699;9317;20541;4854;6550;6094;17498;0;0;0;0;54565;146.0;2016;False;27;6.228881278538813
999.0;Mosolygó Attila;1978;M2;HUN;-;Budapest;M;124;;5579;5962;7020;18561;5914;6058;10535;22507;0;0;0;0;0;0;0;0;41068;101.0;2016;False;38;6.776897689768977
999.0;Túri Márton;1992;M1;HUN;-;Paks;M;283;;4941;4990;5300;15231;5048;5070;6704;16822;4103;5424;4637;14164;0;0;0;0;46217;146.0;2016;False;24;5.275913242009132
999.0;Pljesovszki Roland;1990;M1;HUN;-;Szarvas;M;262;;5387;5275;7348;18010;5874;6369;11385;23628;0;0;0;0;0;0;0;0;41638;101.0;2016;False;26;6.870957095709572
999.0;Kecskés László;1964;M4;HUN;-;Budapest;M;140;;5150;6286;7638;19074;5888;5923;10373;22184;4716;7862;6823;19401;0;0;0;0;60659;146.0;2016;False;52;6.924543378995434
999.0;Czeglédy Csaba dr.;1976;M3;HUN;-;Szombathely;M;125;;5292;5583;6143;17018;5940;7451;9690;23081;0;0;0;0;0;0;0;0;40099;101.0;2016;False;40;6.616996699669968
999.0;Ladányi Róbert;1954;M5;HUN;Óbudai Futókör;Budapest;M;253;;5808;6196;6482;18486;0;0;0;0;0;0;0;0;0;0;0;0;18486;48.0;2016;False;62;6.41875
999.0;Zsigri Szabolcs dr.;1976;M3;HUN;DK Team;Budapest;M;107;;6210;7141;8304;21655;0;0;0;0;5875;8892;7602;22369;6775;10098;8202;25075;69099;142.0;2016;False;40;8.110211267605635
999.0;Pikler Balázs;1976;M3;HUN;-;Kiskorpád;M;111;;5670;0;0;5670;0;0;0;0;0;0;0;0;0;0;0;0;5670;15.0;2016;False;40;6.3
999.0;Schmidt Norbert;1985;M2;HUN;-;Budapest;M;200;;4773;5104;5459;15336;4914;5009;7207;17130;4011;5667;4911;14589;0;0;0;0;47055;146.0;2016;False;31;5.3715753424657535
999.0;Földházi Erzsébet dr.;1962;F3;HUN;Sportzoona;Budapest;F;270;;6652;6903;7778;21333;6750;7684;12473;26907;7439;0;0;7439;0;0;0;0;55679;114.0;2016;False;54;8.140204678362574
999.0;Feszt István Richárd;1993;M1;HUN;-;Budapest;M;297;;5058;7248;9496;21802;6803;10003;0;16806;5860;9548;7765;23173;6647;11486;0;18133;79914;159.0;2016;False;23;8.376729559748428
999.0;Sümegi Roland;1978;M2;HUN;-;Szécsény;M;188;;5526;6313;7374;19213;6472;6959;10248;23679;0;0;0;0;0;0;0;0;42892;101.0;2016;False;38;7.077887788778878
999.0;Berzy Judith;1973;F3;HUN;-;Budapest;F;22;;6817;0;0;6817;0;0;0;0;0;0;0;0;0;0;0;0;6817;15.0;2016;False;43;7.574444444444444
1.0;Csécsei Zoltán;1984;M2;HUN;Szufla SE;Marcali;M;341;F2/1;4083;4304;4427;12814;4209;4145;5794;14148;3502;4570;3611;11683;3876;5386;4006;13268;51913;194.0;2015;True;31;4.459879725085911
2.0;Lux, Christoph;1978;M2;GER;TG Viktoria Augsburg/ LC Altdorf;Altdorf;M;439;F2/2;4297;4365;4448;13110;4421;4303;5744;14468;3519;4479;3453;11451;3875;5359;3778;13012;52041;194.0;2015;True;37;4.470876288659794
3.0;Cserpák Tamás;1978;M2;HUN;Nike Futócenter Nyíregyháza;Nyíregyháza;M;251;F2/3;4427;4466;4417;13310;4511;4373;5648;14532;3536;4396;3332;11264;3930;5301;3772;13003;52109;194.0;2015;True;37;4.476718213058419
4.0;Rákóczi Viktor;1976;M2;HUN;-;Sukoró;M;186;F2/4;4138;4240;4491;12869;4327;4241;6065;14633;3484;4582;3816;11882;3953;5888;4484;14325;53709;194.0;2015;True;39;4.614175257731959
5.0;Roskovics Miklós;1970;M3;HUN;-;Érd;M;170;F3/1;4364;0;8870;13234;4430;4416;6170;15016;3646;4816;3714;12176;4012;5686;4143;13841;54267;194.0;2015;True;45;4.6621134020618555
6.0;Juhász Péter;1970;M3;HUN;Spuri SC;Budapest;M;352;F3/2;3922;0;8966;12888;4210;4435;8334;16979;3454;0;8068;11522;3762;5388;4162;13312;54701;194.0;2015;True;45;4.699398625429553
7.0;Pintér Tibor;1977;M2;HUN;Micro SC;Budapest;M;302;F2/5;4400;4192;4448;13040;4216;4162;5870;14248;3506;0;8782;12288;4403;6358;4413;15174;54750;194.0;2015;True;38;4.703608247422681
8.0;Tóth Csaba;1973;M3;HUN;-;Budapest;M;144;F3/3;4368;4503;4792;13663;4488;4593;6547;15628;3666;4732;3722;12120;4021;5769;4639;14429;55840;194.0;2015;True;42;4.797250859106529
9.0;Kaluz Ákos Bertalan;1981;M2;HUN;Honvéd Szondi SE;Seregélyes;M;342;F2/6;4503;4609;5003;14115;4545;4492;6485;15522;3678;4916;3907;12501;4203;5950;4501;14654;56792;194.0;2015;True;34;4.879037800687285
10.0;Riudavets Gomila, Raül;1973;M3;ESP;Sant Lluis;Es Mercadal;M;440;F3/4;4651;4740;4866;14257;4711;4556;6353;15620;3905;5027;3803;12735;4237;5907;4202;14346;56958;194.0;2015;True;42;4.893298969072164
11.0;Solé Mestre, Jordi;1967;M3;ESP;Compressport Team;Barcelona;M;421;F3/5;4651;4739;4870;14260;4706;4558;6353;15617;3903;5016;3817;12736;4233;5909;4241;14383;56996;194.0;2015;True;48;4.896563573883161
12.0;Morar, Horatiu;1975;M3;ROM;Runners Club;CLUJ NAPOCA;M;444;F2/7;4468;4556;4830;13854;4745;4583;6821;16149;3882;4877;3819;12578;4281;5941;4258;14480;57061;194.0;2015;True;40;4.902147766323024
13.0;Mészáros László;1978;M2;HUN;Futóbarátok Egyesület;Győr;M;167;F2/8;4433;0;9237;13670;4587;4636;6450;15673;3774;4938;3981;12693;4294;6245;4605;15144;57180;194.0;2015;True;37;4.912371134020619
14.0;Klebercz Tamas;1973;M3;HUN;-;Vác;M;155;F3/6;4359;4396;4683;13438;4475;4395;6756;15626;3660;4888;4154;12702;4169;6442;5157;15768;57534;194.0;2015;True;42;4.942783505154639
15.0;Dóbé Zsolt;1974;M3;HUN;-;Szeged;M;310;F3/7;0;0;13408;13408;4478;4655;7055;16188;3647;4980;4249;12876;4197;6167;4896;15260;57732;194.0;2015;True;41;4.95979381443299
1.0;Dupont, Mieke;1973;F3;BEL;-;Blankenberge;F;419;N3/1;4804;4769;4769;14342;4757;4569;6272;15598;3970;5085;3865;12920;4424;6083;4574;15081;57941;194.0;2015;True;42;4.97774914089347
16.0;Csépe György ifj;1971;M3;HUN;-;Gyöngyös;M;316;F3/8;0;0;13315;13315;4382;4526;6806;15714;3734;5325;4372;13431;4196;6819;4927;15942;58402;194.0;2015;True;44;5.017353951890034
17.0;Kovács Ádám;1973;M3;HUN;-;Budapest;M;262;F3/9;4799;4776;4711;14286;4646;4542;6430;15618;3897;5045;4193;13135;4233;6279;5042;15554;58593;194.0;2015;True;42;5.033762886597938
18.0;Papp Sándor;1970;M3;HUN;Debreceni Rendőr SE;Vámospércs;M;280;F3/10;4541;4637;4927;14105;4768;4789;7033;16590;3886;4999;3986;12871;0;10517;4788;15305;58871;194.0;2015;True;45;5.057646048109965
19.0;Palmans, Peter;1962;M4;BEL;-;Neerpelt;M;411;F3/11;4828;4994;4976;14798;5034;4942;6538;16514;4074;5235;3823;13132;4264;5941;4369;14574;59018;194.0;2015;True;53;5.070274914089347
20.0;Járosi Tamás;1973;M3;HUN;Zebra Futóklub;Budapest;M;105;F3/12;4149;4568;5124;13841;4441;4744;6969;16154;3954;5436;4189;13579;4230;6655;4947;15832;59406;194.0;2015;True;42;5.103608247422681
2.0;Ladányi Tímea;1986;F2;HUN;MAC;Budapest;F;253;N2/1;4513;4759;5006;14278;4768;4828;6741;16337;3933;5306;4101;13340;4512;6364;4667;15543;59498;194.0;2015;True;29;5.1115120274914085
21.0;Gömöri, József;1964;M4;SRB;-;Kanizsa;M;307;F3/13;4569;4793;5425;14787;0;9634;6637;16271;3933;5291;4246;13470;4304;6230;4650;15184;59712;194.0;2015;True;51;5.129896907216495
22.0;Pintér Sándor;1975;M3;HUN;Pénzügyőr SE;Gödöllő;M;314;F3/14;4738;4770;4935;14443;4698;4672;6780;16150;3885;5282;4331;13498;4270;6616;5021;15907;59998;194.0;2015;True;40;5.15446735395189
23.0;Geréd László Ifj.;1970;M3;HUN;-;Balatonalmádi;M;355;F3/15;4913;4942;5124;14979;5076;4938;6605;16619;4040;5234;3972;13246;4430;6262;4578;15270;60114;194.0;2015;True;45;5.164432989690722
24.0;Bognár Ákos dr.;1977;M2;HUN;-;Érd;M;163;F2/9;4940;4917;4941;14798;4859;4853;6848;16560;4058;5350;3953;13361;4476;6375;4865;15716;60435;194.0;2015;True;38;5.19201030927835
25.0;Márkus István;1972;M3;HUN;Kadarka Futóegyesület;Szekszárd;M;353;F3/16;4796;4888;5204;14888;4980;4839;6674;16493;4093;5279;4081;13453;4595;6489;4539;15623;60457;194.0;2015;True;43;5.193900343642611
26.0;Pálfi János;1977;M2;HUN;-;Waterloo;M;171;F2/10;4210;0;9838;14048;4553;4724;7387;16664;3765;0;9917;13682;4273;6684;5113;16070;60464;194.0;2015;True;38;5.194501718213059
27.0;Toldi Péter;1981;M2;HUN;-;Szeged;M;158;F2/11;5274;5255;5305;15834;5337;5196;6650;17183;4297;5226;3761;13284;4504;6047;4122;14673;60974;194.0;2015;True;34;5.238316151202749
28.0;Salamon István;1962;M4;HUN;-;Mezőtárkány;M;34;F3/17;4773;4894;5769;15436;5028;5047;6890;16965;3847;5138;3936;12921;4451;6354;4847;15652;60974;194.0;2015;True;53;5.238316151202749
3.0;Martinák Anikó;1973;F3;HUN;-;Budapest;F;181;N3/2;4542;4788;4854;14184;4728;4622;6783;16133;3978;5863;4465;14306;4602;7053;4980;16635;61258;194.0;2015;True;42;5.262714776632302
29.0;Jakab Attila;1985;M2;HUN;-;Székelyudvarhely;M;121;F2/12;4926;4970;5323;15219;5204;5019;6573;16796;4070;5110;3876;13056;4638;6619;4943;16200;61271;194.0;2015;True;30;5.263831615120274
30.0;Kertész Ervin;1970;M3;HUN;Futóbarátok Egyyesület Győr;Ásványráró;M;175;F3/18;4847;5194;5653;15694;5236;5181;6645;17062;3971;5018;4254;13243;4514;6362;4416;15292;61291;194.0;2015;True;45;5.265549828178694
4.0;Molnár Gitta;1983;F2;HUN;-;Békéscsaba;F;347;N2/2;5209;5251;5434;15894;5132;4950;6993;17075;4024;5240;4136;13400;4442;6200;4495;15137;61506;194.0;2015;True;32;5.284020618556701
31.0;Keller Elek;1978;M2;HUN;Tűzoltóság;Püspökladány;M;286;F2/13;4977;5158;5797;15932;5130;4948;6997;17075;4021;5243;4140;13404;4442;6200;4500;15142;61553;194.0;2015;True;37;5.288058419243987
32.0;Séra István;1960;M4;HUN;Futóbolondok SE;Budapest;M;36;F3/19;4585;4846;5069;14500;4708;4918;7542;17168;3960;5266;4171;13397;4645;7065;5129;16839;61904;194.0;2015;True;55;5.318213058419244
33.0;Gere Zoltán;1968;M3;HUN;Sportstuffracine;Gyöngyös;M;294;F3/20;4416;4617;5037;14070;4692;4563;6927;16182;3956;5318;4670;13944;4235;7273;6201;17709;61905;194.0;2015;True;47;5.318298969072165
34.0;Békési László;1967;M3;HUN;-;Budapest;M;325;F3/21;4590;4873;5299;14762;4772;5165;6960;16897;3977;5628;4252;13857;4590;6766;5067;16423;61939;194.0;2015;True;48;5.321219931271477
35.0;Bakó Gábor;1968;M3;HUN;-;Budakalász;M;173;F3/22;4656;4857;4949;14462;4828;5216;7500;17544;3995;5606;4415;14016;4647;6637;4959;16243;62265;194.0;2015;True;47;5.349226804123711
36.0;Kozma Zsolt;1987;M2;HUN;Futeam SE;Tök;M;304;F2/14;4629;5042;5907;15578;4955;4989;7130;17074;3797;5245;4198;13240;4433;6744;5210;16387;62279;194.0;2015;True;28;5.350429553264605
5.0;Kelemen Nóra;1972;F3;HUN;B784 Team;Budapest;F;281;N3/3;4939;4965;5072;14976;5085;0;11990;17075;4282;0;9514;13796;4690;6700;5083;16473;62320;194.0;2015;True;43;5.353951890034365
37.0;Hogya Dénes;1981;M2;HUN;-;Miskolc (Szirma);M;133;F2/15;5134;5119;5511;15764;5027;5130;7047;17204;4067;5575;4500;14142;4302;6226;4719;15247;62357;194.0;2015;True;34;5.35713058419244
6.0;Kovács Éva Dr.;1986;F2;HUN;-;Budapest;F;270;N2/3;4552;4817;4962;14331;4902;4886;7499;17287;4062;5534;4271;13867;4540;7098;5259;16897;62382;194.0;2015;True;29;5.359278350515464
38.0;Nick, Elford;1976;M2;GBR;-;Woking;M;437;F2/16;4423;4607;5868;14898;4838;5084;7758;17680;3883;5232;4324;13439;4460;6831;5113;16404;62421;194.0;2015;True;39;5.362628865979381
39.0;Szőke Tamás;1970;M3;HUN;Honvéd Szondi SE;Székesfehérvár;M;14;F3/23;4565;4573;5090;14228;4669;4796;7078;16543;4447;6237;5663;16347;4303;6412;4720;15435;62553;194.0;2015;True;45;5.3739690721649485
40.0;Kollár Szabolcs;1970;M3;HUN;Záróbusz Felvezetők ESK;Budapest;M;329;F3/24;4640;4795;5619;15054;5423;5299;6865;17587;4041;5279;4289;13609;4738;6543;5089;16370;62620;194.0;2015;True;45;5.379725085910653
41.0;Jánowszky Zoltán;1980;M2;HUN;Vinibike KSE;Nyíregyháza;M;160;F2/17;5045;5388;5361;15794;5156;5123;7242;17521;4077;5436;4245;13758;4497;6545;4783;15825;62898;194.0;2015;True;35;5.40360824742268
42.0;Túri Márton;1992;M1;HUN;-;Paks;M;337;F1/1;5047;5215;5223;15485;5230;5258;6689;17177;4220;5519;4171;13910;4661;6596;5102;16359;62931;194.0;2015;True;23;5.406443298969072
7.0;Marton-Mlecsenkov Éva;1979;F2;HUN;Élményfutárok;Budapest;F;335;N2/4;4725;4871;5164;14760;4821;5178;7194;17193;4209;5911;4501;14621;4429;7564;4856;16849;63423;194.0;2015;True;36;5.448711340206185
43.0;Nagy Imre;1981;M2;HUN;Záróbusz Felvezetők ESK;Egyek;M;332;F2/18;4773;4924;5617;15314;5166;4954;7642;17762;4003;5566;4425;13994;4715;6784;5175;16674;63744;194.0;2015;True;34;5.4762886597938145
8.0;Csapó Judit;1973;F3;HUN;Teljesítménytúrázók Társasága;Osztopán;F;309;N3/4;4633;4987;5371;14991;4845;5229;7580;17654;4071;5686;4672;14429;4477;6846;5353;16676;63750;194.0;2015;True;42;5.47680412371134
44.0;Blaskó Mihály;1980;M2;HUN;-;Monorierdő;M;185;F2/19;4797;5108;5313;15218;5175;5317;7164;17656;4214;5602;4323;14139;4818;6823;5271;16912;63925;194.0;2015;True;35;5.491838487972509
45.0;Molnár János;1978;M2;HUN;-;Budapest;M;275;F2/20;4612;4622;5416;14650;4846;5109;7392;17347;4086;0;10995;15081;4597;7184;5075;16856;63934;194.0;2015;True;37;5.492611683848797
46.0;Nedeczky László Tamás;1984;M2;HUN;-;Budapest;M;148;F2/21;5468;5357;5572;16397;5260;5064;6832;17156;4245;5562;4171;13978;4817;6789;4840;16446;63977;194.0;2015;True;31;5.496305841924398
47.0;Pók János;1963;M4;HUN;Axiál Kft.;Gárdony (Agárd);M;33;F3/25;4922;5096;5294;15312;5232;5174;7360;17766;4431;5708;4282;14421;4660;6827;5075;16562;64061;194.0;2015;True;52;5.50352233676976
48.0;Szabó László;1957;M4;HUN;Alföld TE;Mezőberény;M;317;F4/1;4810;4797;5265;14872;5243;5117;7172;17532;4222;5691;4403;14316;4802;7175;5458;17435;64155;194.0;2015;True;58;5.51159793814433
49.0;Tigyi László;1960;M4;HUN;BFC Futapest;Budapest;M;112;F3/26;4516;4976;5586;15078;4794;5051;7617;17462;3870;6090;5057;15017;4749;6883;5299;16931;64488;194.0;2015;True;55;5.54020618556701
50.0;Dovala, Adrian;1975;M3;SVK;Drnava;Drnava;M;406;F3/27;4965;5119;5278;15362;5166;5125;7155;17446;4371;5797;4666;14834;4754;6821;5294;16869;64511;194.0;2015;True;40;5.542182130584193
51.0;Hergovics Gábor;1965;M3;HUN;Szondi SE;Székesfehérvár;M;343;F3/28;4922;5096;5294;15312;5235;5177;7356;17768;4586;5347;4069;14002;4736;6789;5968;17493;64575;194.0;2015;True;50;5.547680412371134
9.0;Bálint Éva;1972;F3;HUN;-;Budapest;F;257;N3/5;4693;4903;5528;15124;5415;5313;7299;18027;4293;5621;4452;14366;4845;7123;5156;17124;64641;194.0;2015;True;43;5.553350515463917
52.0;Földesi József;1957;M4;HUN;Tapolcai Honvéd SE;Tapolca;M;350;F4/2;5087;5165;5352;15604;5231;5211;7175;17617;4313;5744;4347;14404;4878;7100;5460;17438;65063;194.0;2015;True;58;5.589604810996564
10.0;Baksai Zsuzsanna;1971;F3;HUN;-;Zsámbék;F;149;N3/6;5403;5471;5521;16395;5565;5250;7112;17927;4404;5512;4212;14128;5005;7000;5106;17111;65561;194.0;2015;True;44;5.632388316151203
53.0;Rácz Róbert;1972;M3;HUN;TVK-Mali Triatlon Klub;Sajóörös;M;147;F3/29;5248;5330;5706;16284;5447;5472;7407;18326;4473;5770;4347;14590;4644;6697;5090;16431;65631;194.0;2015;True;43;5.63840206185567
54.0;Andrási Csaba dr.;1972;M3;HUN;-;Nyíregyháza;M;128;F3/30;4930;5089;5509;15528;5266;5327;7714;18307;4121;5682;4792;14595;4760;7167;5328;17255;65685;194.0;2015;True;43;5.643041237113402
11.0;Kusatz, Patricia;1969;F3;GER;-;Berlin;F;420;N3/7;5360;5532;5904;16796;5739;5644;7508;18891;4211;5433;4160;13804;4558;6652;5076;16286;65777;194.0;2015;True;46;5.6509450171821305
55.0;Kollin Gábor Gergely;1972;M3;HUN;-;Budapest;M;107;F3/31;5476;5486;5667;16629;5692;5630;7221;18543;4576;5747;4158;14481;4821;6747;4696;16264;65917;194.0;2015;True;43;5.662972508591065
56.0;Ugrai Béla;1968;M3;HUN;Mogyi SE Baja;Baja;M;327;F3/32;4793;4889;5443;15125;5388;5446;7825;18659;4307;5647;4486;14440;4605;7301;6032;17938;66162;194.0;2015;True;47;5.684020618556701
57.0;Vadász Attila;1964;M4;HUN;Tapolca Honvéd SE;Szigliget;M;289;F3/33;5211;5342;5465;16018;5264;5357;7289;17910;4290;5993;4729;15012;4733;7304;5446;17483;66423;194.0;2015;True;51;5.706443298969072
12.0;Rumyantseva, Evgeniya;1984;F2;RUS;-;Moscow;F;441;N2/5;4881;5030;6061;15972;5177;5088;7320;17585;4316;5734;4930;14980;4954;7410;5529;17893;66430;194.0;2015;True;31;5.707044673539519
58.0;Horváth Bálint;1981;M2;HUN;-;Rum;M;174;F2/22;4992;5264;5857;16113;5258;5299;7590;18147;4306;5629;4809;14744;4980;7205;5332;17517;66521;194.0;2015;True;34;5.714862542955327
59.0;Lukovics Béla;1953;M5;HUN;Békéscsabai AC;Békéscsaba;M;58;F4/3;5064;5348;5783;16195;5422;5486;7892;18800;4538;6114;4835;15487;4727;6525;4883;16135;66617;194.0;2015;True;62;5.7231099656357385
60.0;Darányi János;1963;M4;HUN;-;Soltvadkert;M;291;F3/34;5142;5252;5426;15820;5360;5437;7493;18290;4401;5910;4563;14874;4932;7389;5338;17659;66643;194.0;2015;True;52;5.725343642611684
61.0;Frank Tibor;1949;M5;HUN;EMU;Budapest;M;274;F4/4;4972;5421;5473;15866;5341;5336;7687;18364;4220;5680;4940;14840;4786;7157;5698;17641;66711;194.0;2015;True;66;5.731185567010309
62.0;Sipos Sándor;1957;M4;HUN;HASE;Budapest;M;287;F4/5;5059;5257;5623;15939;5343;5366;7722;18431;4514;6012;4773;15299;4842;7069;5139;17050;66719;194.0;2015;True;58;5.7318728522336775
63.0;Rokob József;1978;M2;HUN;-;Győr;M;161;F2/23;4417;4869;5705;14991;5404;5471;7887;18762;4486;6126;4631;15243;5152;7447;5374;17973;66969;194.0;2015;True;37;5.753350515463918
13.0;Szilágyi Szvetlana;1976;F2;HUN;-;Békéscsaba;F;346;N2/6;5207;5425;5721;16353;5559;0;13146;18705;4539;5845;4449;14833;4954;7203;5276;17433;67324;194.0;2015;True;39;5.783848797250859
64.0;Török Tamás;1992;M1;HUN;Pécsi testkultúra Közhasznú Egyesület;Áta;M;303;F1/2;5197;5292;5911;16400;4975;5047;8804;18826;4290;5814;4738;14842;4454;7217;5964;17635;67703;194.0;2015;True;23;5.816408934707904
65.0;Vakhal György;1955;M5;HUN;Honvéd Rákóczi SE;Szentes;M;338;F4/6;4745;5071;6807;16623;5112;5393;8110;18615;4214;5962;4839;15015;4702;7136;5935;17773;68026;194.0;2015;True;60;5.844158075601374
66.0;Fejes Zoltán;1974;M3;HUN;-;Békéscsaba;M;348;F3/35;5215;5460;6078;16753;5708;5656;7931;19295;4621;6053;4399;15073;4757;7147;5340;17244;68365;194.0;2015;True;41;5.873281786941581
67.0;Mészáros Sándor;1971;M3;HUN;KEFE;Komárom;M;336;F3/36;5255;5107;5471;15833;5118;5228;7658;18004;4475;6276;4987;15738;4995;8086;5756;18837;68412;194.0;2015;True;44;5.877319587628866
14.0;Plavecz Andrea;1978;F2;HUN;-;Békéscsaba;F;345;N2/7;5203;5427;6123;16753;5685;5684;7905;19274;4461;5756;4466;14683;4875;7389;5609;17873;68583;194.0;2015;True;37;5.8920103092783505
15.0;Pap-Csákvári Judit;1970;F3;HUN;-;Tiszaújváros;F;183;N3/8;5431;5621;5875;16927;5853;5741;7826;19420;4700;6165;4739;15604;5072;6879;4710;16661;68612;194.0;2015;True;45;5.894501718213058
16.0;Viane, Ruth;1966;F3;BEL;-;bruges;F;412;N3/9;5093;5417;5754;16264;5454;5791;8425;19670;4547;6017;4578;15142;5100;7347;5284;17731;68807;194.0;2015;True;49;5.911254295532646
68.0;Pljesovszki Roland;1990;M1;HUN;Mogyi SE Baja;Szarvas;M;267;F1/3;5073;5074;6971;17118;5403;5445;11528;22376;4265;5325;4041;13631;4129;6593;5127;15849;68974;194.0;2015;True;25;5.925601374570446
69.0;Köves Péter;1972;M3;HUN;Kanizsai Futóklub;Nagykanizsa;M;124;F3/37;5087;5452;5846;16385;5545;5721;8003;19269;4492;6051;4586;15129;5294;7545;5486;18325;69108;194.0;2015;True;43;5.937113402061855
70.0;Harper, Colin;1964;M4;GBR;-;Chelmsford;M;438;F3/38;5312;5485;5367;16164;5340;5401;7112;17853;4442;5815;4359;14616;4815;7215;8473;20503;69136;194.0;2015;True;51;5.939518900343643
71.0;Beckmann, Michael;1969;M3;GER;TVE Weiher;Forst;M;422;F3/39;5490;5556;5882;16928;5519;5567;7736;18822;4547;6038;4716;15301;5086;7725;5322;18133;69184;194.0;2015;True;46;5.943642611683848
72.0;Major Balázs;1974;M3;HUN;-;Budapest;M;146;F3/40;5686;5838;6074;17598;5772;5625;7684;19081;4620;5964;4443;15027;5164;7259;5211;17634;69340;194.0;2015;True;41;5.957044673539519
73.0;Sutyinszky Tamás;1972;M3;HUN;-;Budapest;M;278;F3/41;5188;5377;5867;16432;5424;5552;7874;18850;4578;6269;4910;15757;5192;7693;5587;18472;69511;194.0;2015;True;43;5.971735395189003
74.0;Simon Péter;1965;M3;HUN;-;Budapest;M;288;F3/42;4807;5726;6099;16632;5416;6019;8412;19847;4372;6023;4942;15337;4795;7345;5726;17866;69682;194.0;2015;True;50;5.986426116838487
75.0;Szabó Balázs;1984;M2;HUN;-;Békéscsaba;M;142;F2/24;5663;5736;5971;17370;5997;6023;7653;19673;4636;6215;4688;15539;5127;7407;4645;17179;69761;194.0;2015;True;31;5.9932130584192445
76.0;Marosi Péter;1975;M3;HUN;IKEA FC;Baja;M;298;F2/25;5524;5554;5612;16690;0;11006;7369;18375;4454;5766;4349;14569;4857;7313;7984;20154;69788;194.0;2015;True;40;5.995532646048111
77.0;Vízer Dániel;1981;M2;HUN;Ironteam SE;Székesfehérvár;M;308;F2/26;5529;5472;5745;16746;5870;5636;7937;19443;4757;6158;4747;15662;5195;7371;5489;18055;69906;194.0;2015;True;34;6.005670103092783
78.0;Szabó István;1977;M2;HUN;Futóbarátok Egyesület;Győr;M;313;F2/27;5246;5538;5680;16464;5910;5669;7748;19327;4820;6202;4581;15603;5400;7564;5568;18532;69926;194.0;2015;True;38;6.007388316151203
79.0;Soós Péter;1970;M3;HUN;Honvéd Szondi SE;Székesfehérvár;M;344;F3/43;5532;5467;5748;16747;5866;5636;7938;19440;4761;6155;4777;15693;5195;7658;5203;18056;69936;194.0;2015;True;45;6.008247422680412
17.0;Csákány Krisztina;1971;F3;HUN;Futóbarátok Egyyesület Győr;Győrújbarát;F;284;N3/10;5629;5908;6018;17555;5745;5678;7687;19110;4704;6109;4627;15440;5147;7372;5334;17853;69958;194.0;2015;True;44;6.0101374570446735
80.0;Kecskés László;1964;M4;HUN;-;Budapest;M;164;F3/44;6115;6475;7074;19664;5724;5663;7864;19251;4318;5695;4501;14514;4684;6883;5052;16619;70048;194.0;2015;True;51;6.01786941580756
81.0;Rácz Krisztián János;1975;M3;HUN;Futó Daru S. E.;Püspökladány;M;134;F2/28;5212;5466;7023;17701;5591;5798;7877;19266;4634;6207;4755;15596;5047;7343;5165;17555;70118;194.0;2015;True;40;6.023883161512028
82.0;Ossó Zoltán;1976;M2;HUN;MAC;Budapest;M;333;F2/29;5275;5446;6009;16730;5489;5770;8330;19589;4536;6218;5084;15838;5030;7447;5852;18329;70486;194.0;2015;True;39;6.055498281786941
83.0;Farkas László;1967;M3;HUN;Futóbolondok SE;Budapest;M;20;F3/45;5583;5801;6024;17408;5793;5590;7846;19229;4728;6192;4824;15744;5222;7465;5512;18199;70580;194.0;2015;True;48;6.063573883161512
84.0;Simon Zoltán;1970;M3;HUN;-;Solymár;M;37;F3/46;5583;5801;6023;17407;5795;5589;7848;19232;4728;6193;4825;15746;5224;7381;5595;18200;70585;194.0;2015;True;45;6.064003436426117
85.0;Garami Csongor;1968;M3;HUN;-;Törökbálint;M;123;F3/47;4889;5193;6172;16254;5314;5667;8957;19938;4544;6341;5432;16317;5098;7505;5704;18307;70816;194.0;2015;True;47;6.083848797250859
86.0;Pikler Balázs;1976;M2;HUN;-;Kiskorpád;M;126;F2/30;5124;5310;6888;17322;5640;5884;8424;19948;4722;6282;4960;15964;5109;7305;5388;17802;71036;194.0;2015;True;39;6.102749140893471
87.0;Rakonczay Gábor;1981;M2;HUN;-;Pusztazámor;M;331;F2/31;4890;5204;6123;16217;5171;5502;8005;18678;4469;6594;5813;16876;5209;8006;6091;19306;71077;194.0;2015;True;34;6.106271477663229
88.0;Ács László;1960;M4;HUN;Szolnoki Honvéd Sportegyesület;Szolnok;M;318;F3/48;5686;5833;5983;17502;5756;5668;8157;19581;4781;6221;4852;15854;5314;7326;5543;18183;71120;194.0;2015;True;55;6.109965635738831
89.0;Drexler Zoltán;1975;M3;HUN;Runberries;Esztergom;M;297;F2/32;5640;5642;6187;17469;6017;5766;8400;20183;4794;6500;5063;16357;5120;7289;4855;17264;71273;194.0;2015;True;40;6.12310996563574
90.0;Balázs Gergely;1985;M2;HUN;Szolnoki Honvéd Sportegyesület;Szolnok;M;356;F2/33;5689;5828;5987;17504;5750;5674;8311;19735;4793;6204;4859;15856;5165;7366;5651;18182;71277;194.0;2015;True;30;6.123453608247423
91.0;Szarvas Mátyás;1988;M1;HUN;-;Békéscsaba;M;157;F2/34;5538;6216;6209;17963;5996;6022;8626;20644;4631;6215;4687;15533;5123;7404;4866;17393;71533;194.0;2015;True;27;6.145446735395189
92.0;Kvarfordt, Kjell;1959;M4;SWE;-;Sollentuna;M;428;F3/49;5680;5780;5929;17389;5827;0;13947;19774;4955;6319;4959;16233;5188;7360;5606;18154;71550;194.0;2015;True;56;6.146907216494846
93.0;Kollár Zoltán;1965;M3;HUN;Knorr-Bremse;Budapest;M;55;F3/50;5698;6130;6393;18221;5928;5859;7820;19607;4994;6425;4756;16175;5252;7368;4982;17602;71605;194.0;2015;True;50;6.151632302405499
94.0;Szabó Zoltán dr;1958;M4;HUN;-;Dunaújváros;M;259;F4/7;5074;5249;5993;16316;5457;6192;9242;20891;4335;0;11046;15381;5360;0;13824;19184;71772;194.0;2015;True;57;6.165979381443299
95.0;Szabó Béla;1963;M4;HUN;-;Gyenesdiás;M;119;F3/51;5470;5557;6337;17364;5709;5722;8245;19676;4716;0;10871;15587;5308;7997;6074;19379;72006;194.0;2015;True;52;6.1860824742268035
96.0;Ozsvár Tihamér;1969;M3;HUN;-;Csantavér;M;306;F3/52;5961;6075;6236;18272;5984;5862;7233;19079;4546;5923;4676;15145;5600;7963;6021;19584;72080;194.0;2015;True;46;6.192439862542955
97.0;Tóth Gábor;1967;M3;HUN;Futóbarátok - Nike Futóklub Győr;Ikrény;M;301;F3/53;5351;5755;6122;17228;5796;5765;8379;19940;4699;6167;5240;16106;5286;7944;5721;18951;72225;194.0;2015;True;48;6.204896907216495
98.0;Hoskó Roland;1976;M2;HUN;-;Budapest;M;273;F2/35;4729;5292;6666;16687;5349;6135;8728;20212;4561;6615;5272;16448;5056;7890;6044;18990;72337;194.0;2015;True;39;6.214518900343642
99.0;Patkós Gábor;1986;M2;HUN;-;Hódmezővásárhely;M;321;F2/36;5863;6468;6965;19296;5938;6053;8397;20388;4742;0;11095;15837;5032;6983;5047;17062;72583;194.0;2015;True;29;6.2356529209622
100.0;Kovács Ákos Flórián;1975;M3;HUN;-;Dunaújváros;M;328;F2/37;5397;5603;6144;17144;5543;5986;8947;20476;4618;6577;5444;16639;5223;7506;5677;18406;72665;194.0;2015;True;40;6.242697594501718
101.0;Sorbán András dr.;1968;M3;HUN;-;Budapest;M;184;F3/54;5699;5822;6003;17524;5904;5876;8360;20140;4801;6499;4938;16238;5301;7801;5727;18829;72731;194.0;2015;True;47;6.248367697594502
18.0;Csúzdi-Hack Zsanett;1984;F2;HUN;-;Nyergesújfalu;F;260;N2/8;5590;5543;6037;17170;5943;5971;9178;21092;4843;6456;4934;16233;5266;7568;5899;18733;73228;194.0;2015;True;31;6.29106529209622
102.0;Szabó Balázs dr.;1970;M3;HUN;-;Budapest;M;103;F3/55;5376;5607;6207;17190;5769;6072;8387;20228;4844;6663;4734;16241;5538;8136;6325;19999;73658;194.0;2015;True;45;6.328006872852234
103.0;Horváth Péter;1968;M3;HUN;-;Szombathely;M;359;F3/56;5518;5764;6240;17522;5782;5940;8525;20247;4866;6734;5333;16933;5346;7896;5901;19143;73845;194.0;2015;True;47;6.344072164948454
104.0;Czaltig Zsolt;1974;M3;HUN;-;Lajoskomárom;M;101;F3/57;5525;5512;5626;16663;5405;5471;7397;18273;4460;6349;5118;15927;5456;9466;8140;23062;73925;194.0;2015;True;41;6.35094501718213
105.0;Olsson, Fredrik;1972;M3;SWE;-;Norsholm;M;430;F3/58;5681;5771;7456;18908;5930;6234;8129;20293;4954;6311;5035;16300;5356;7740;5425;18521;74022;194.0;2015;True;43;6.359278350515464
106.0;Prekopp Péter Dr.;1978;M2;HUN;AVSE;Budapest;M;156;F2/38;5376;5608;6207;17191;5768;6070;8388;20226;4845;6660;5136;16641;5535;8206;6254;19995;74053;194.0;2015;True;37;6.361941580756014
107.0;Veres, Sandor;1962;M4;GER;-;Chemnitz;M;176;F3/59;6079;6432;5700;18211;6394;6369;7816;20579;4988;6514;4589;16091;5728;8321;5278;19327;74208;194.0;2015;True;53;6.375257731958762
108.0;Orosi László;1978;M2;HUN;-;Budapest;M;135;F2/39;4936;5478;6702;17116;5522;6030;9029;20581;4781;7040;5460;17281;5190;8000;6165;19355;74333;194.0;2015;True;37;6.385996563573884
109.0;Preil József;1978;M2;HUN;-;Székesfehérvár;M;177;F2/40;5366;5842;6418;17626;6058;6347;8623;21028;4771;6613;5426;16810;5383;8209;6089;19681;75145;194.0;2015;True;37;6.455756013745705
110.0;Kulcsár Lajos;1971;M3;HUN;-;Szentendre;M;349;F3/60;4839;5697;6875;17411;5809;6040;8759;20608;4376;6608;6229;17213;5402;8185;6390;19977;75209;194.0;2015;True;44;6.461254295532646
19.0;Békésiné Janik Szilvia;1977;F2;HUN;-;Budapest;F;326;N2/9;5345;6041;6675;18061;5552;6522;8644;20718;4800;6931;5058;16789;5428;8186;6028;19642;75210;194.0;2015;True;38;6.461340206185567
111.0;Szerencsés Szabolcs;1973;M3;HUN;Szolnoki Honvéd Sportegyesület;Szolnok;M;357;F3/61;5677;5890;6393;17960;6186;6597;8940;21723;4964;6417;5246;16627;5464;7821;6004;19289;75599;194.0;2015;True;42;6.494759450171822
112.0;Komjáti Sándor dr;1964;M4;HUN;Tapolca Honvéd SE;Tapolca (Diszel);M;351;F3/62;5598;6298;7306;19202;5449;5628;8518;19595;4754;6492;5396;16642;5389;8256;6609;20254;75693;194.0;2015;True;51;6.502835051546391
113.0;Kincse Szabolcs;1973;M3;HUN;-;Budapest;M;118;F3/63;5702;5819;6003;17524;5906;6398;8787;21091;5052;6841;5142;17035;5420;8525;6159;20104;75754;194.0;2015;True;42;6.50807560137457
114.0;Tálas Krisztián dr.;1976;M2;HUN;-;Szabadbattyán;M;178;F2/41;5318;5754;7701;18773;5923;6388;9180;21491;4716;6954;5154;16824;5394;7603;5727;18724;75812;194.0;2015;True;39;6.513058419243986
115.0;Rudolf József dr.;1970;M3;HUN;-;Budapest;M;137;F3/64;5501;6050;6473;18024;6005;6220;8743;20968;4858;7421;4953;17232;5347;8351;6275;19973;76197;194.0;2015;True;45;6.546134020618557
116.0;Korcsmáros Tamás;1972;M3;HUN;-;Békéscsaba;M;322;F3/65;6300;6650;6598;19548;6803;7004;9615;23422;5021;6226;4867;16114;5479;7073;4798;17350;76434;194.0;2015;True;43;6.566494845360825
20.0;Kiss Virág;1976;F2;HUN;-;Szatymaz;F;159;N2/10;5626;5658;6459;17743;5638;5779;9065;20482;4811;6771;5989;17571;5341;8397;7069;20807;76603;194.0;2015;True;39;6.5810137457044675
117.0;Honkó Mátyás;1951;M5;HUN;-;Szeged;M;132;F4/8;5937;5827;6274;18038;6195;6289;8602;21086;5274;6911;5218;17403;5581;8292;6893;20766;77293;194.0;2015;True;64;6.640292096219931
118.0;Dávid Zoltán;1967;M3;HUN;Triász;Nyíregyháza;M;271;F3/66;5621;5917;6015;17553;6146;6408;9238;21792;5015;7076;5399;17490;5894;8590;6037;20521;77356;194.0;2015;True;48;6.645704467353951
119.0;Brandstaetter, Christian;1961;M4;AUT;Club Sport Spezial Innsbruck;Sulz i. Wienerwald;M;416;F3/67;6168;6375;6434;18977;6456;6269;8341;21066;5305;6799;5020;17124;6003;8234;6022;20259;77426;194.0;2015;True;54;6.65171821305842
120.0;Klam Csaba;1970;M3;HUN;-;Soltvadkert;M;29;F3/68;5514;6215;6282;18011;6324;6633;9171;22128;4725;6701;5274;16700;5521;8540;6782;20843;77682;194.0;2015;True;45;6.673711340206186
121.0;Tóth István;1978;M2;HUN;Óbudai Futókör;Budapest;M;113;F2/42;5709;6073;7147;18929;6343;6147;8965;21455;5089;6622;5099;16810;5682;0;15015;20697;77891;194.0;2015;True;37;6.691666666666667
21.0;Olaj, Itta;1968;F3;AUT;LG Mauerweg Berlin e.V.;Berlin;F;432;N3/11;6050;6347;6466;18863;6469;6352;8295;21116;5306;6860;5156;17322;6003;8336;6324;20663;77964;194.0;2015;True;47;6.697938144329897
122.0;Von Uleniecki, Alexander;1968;M3;GER;LG Mauerweg Berlin e.V.;Berlin;M;417;F3/69;6049;6347;6467;18863;6467;6346;8305;21118;5300;6869;5149;17318;6003;8334;6331;20668;77967;194.0;2015;True;47;6.69819587628866
123.0;Krabácz Miklós;1959;M4;HUN;Buda Fitness;Budapest;M;136;F3/70;5580;5981;6280;17841;6152;6728;9366;22246;5075;6977;5735;17787;5634;8395;6541;20570;78444;194.0;2015;True;56;6.739175257731959
124.0;Körmöczy Zoltán;1971;M3;HUN;Dabasi SE;Vecsés;M;168;F3/71;6135;6416;6824;19375;6374;6625;9321;22320;5047;6735;5102;16884;5763;8094;6146;20003;78582;194.0;2015;True;44;6.7510309278350515
125.0;Szántó Árpád;1974;M3;HUN;-;Kecskemét;M;182;F3/72;6206;7863;7536;21605;0;0;20820;20820;0;11734;3999;15733;5495;9661;5673;20829;78987;194.0;2015;True;41;6.7858247422680416
126.0;Heitfeldt, Ulrich;1957;M4;GER;-;Hohenhameln;M;407;F4/9;5668;5763;6558;17989;6043;6318;9910;22271;4868;7087;5737;17692;5725;8621;6795;21141;79093;194.0;2015;True;58;6.7949312714776635
127.0;Lajszner Lajos;1966;M3;HUN;Egri triatlon klub;Eger;M;130;F3/73;5664;6256;7227;19147;6246;6636;8819;21701;5089;7086;5086;17261;5737;8823;6434;20994;79103;194.0;2015;True;49;6.795790378006873
128.0;Lembke, Peter;1971;M3;SWE;-;Sollentuna;M;426;F3/74;6168;6758;8031;20957;5598;6107;8375;20080;4999;6840;5166;17005;5382;9523;7167;22072;80114;194.0;2015;True;44;6.882646048109966
22.0;Fejér Zsuzsa;1971;F3;HUN;-;Budapest;F;145;N3/12;5826;6218;6135;18179;5949;6063;8250;20262;4891;7205;5521;17617;5800;9816;8545;24161;80219;194.0;2015;True;44;6.891666666666667
129.0;Hajduk, Pavol;1973;M3;SVK;-;Dolný Kubín;M;410;F3/75;5304;5519;7135;17958;5890;6276;9839;22005;5492;7956;6114;19562;5697;8942;6408;21047;80572;194.0;2015;True;42;6.921993127147766
23.0;Bálits Éva;1966;F3;HUN;-;Diósd;F;106;N3/13;5828;6352;6816;18996;5962;6334;8916;21212;5095;7059;5543;17697;5801;9807;7238;22846;80751;194.0;2015;True;49;6.937371134020618
130.0;Kóder Gábor;1981;M2;HUN;Újpalota SC;Dunakeszi;M;290;F2/43;5261;5432;5695;16388;5809;6493;9068;21370;5470;8201;7229;20900;7143;8182;7079;22404;81062;194.0;2015;True;34;6.964089347079038
24.0;Gren, Susanne;1963;F3;SWE;Frisksi o svettis Helsingborg;Påarp;F;414;N3/14;5553;6027;8684;20264;6081;6513;9384;21978;5205;7141;5415;17761;5916;8749;6465;21130;81133;194.0;2015;True;52;6.970189003436427
131.0;Bakos Gábor;1966;M3;HUN;-;Dunakeszi;M;285;F3/76;5267;6183;7944;19394;5718;6545;10052;22315;4600;8137;6413;19150;5550;8624;6465;20639;81498;194.0;2015;True;49;7.001546391752577
132.0;Péter Ferenc;1971;M3;HUN;-;Szeged;M;292;F3/77;5711;6759;7063;19533;5992;6574;9695;22261;5229;6855;5774;17858;5989;9020;7053;22062;81714;194.0;2015;True;44;7.020103092783506
133.0;Nilsson, Jörgen;1950;M5;SWE;Vi som springer;Hisssingskaerra;M;427;F4/10;5763;0;13729;19492;6232;6612;10124;22968;5090;6909;5528;17527;5769;9333;6777;21879;81866;194.0;2015;True;65;7.033161512027491
134.0;Dzsupin István;1969;M3;HUN;-;Pomáz;M;311;F3/78;6038;6589;7040;19667;6642;6541;10397;23580;5294;7176;5511;17981;5964;8705;6069;20738;81966;194.0;2015;True;46;7.0417525773195875
25.0;Krivács Henrietta;1983;F2;HUN;Pénzügyőr SE;Nyírbátor;F;340;N2/11;5160;5479;6556;17195;6037;7027;9883;22947;4754;7616;6129;18499;5844;9638;8150;23632;82273;194.0;2015;True;32;7.068127147766323
135.0;Czabán László dr.;1968;M3;HUN;-;Jakabszállás;M;143;F3/79;6218;6345;6776;19339;6619;6759;9134;22512;5371;7222;5665;18258;6331;9462;6439;22232;82341;194.0;2015;True;47;7.073969072164948
136.0;Kőrösi Koppány dr.;1971;M3;HUN;-;Budapest;M;169;F3/80;5321;5754;6790;17865;5977;6391;10139;22507;4697;7500;6490;18687;5367;0;18049;23416;82475;194.0;2015;True;44;7.085481099656357
137.0;Gren, Tony;1961;M4;SWE;Frisksi o svettis Helsingborg;Påarp;M;415;F3/81;5388;6114;8762;20264;5800;6289;9332;21421;4663;7061;6261;17985;5773;9437;7679;22889;82559;194.0;2015;True;54;7.092697594501718
138.0;Ameys, Patrick;1961;M4;BEL;-;Oudenaken;M;402;F3/82;6102;6466;6880;19448;6544;6764;9985;23293;5402;6802;6263;18467;6321;8783;6314;21418;82626;194.0;2015;True;54;7.098453608247422
139.0;Voet, Philippe;1975;M3;BEL;-;Vlezenbeek;M;401;F2/44;6102;6465;6876;19443;6549;6757;9990;23296;5405;6806;6272;18483;6324;8832;6266;21422;82644;194.0;2015;True;40;7.1000000000000005
140.0;Kreszta Zoltán;1970;M3;HUN;-;Budapest;M;11;F3/83;5527;6074;7685;19286;5931;7133;9764;22828;5298;7910;5767;18975;6004;8776;6916;21696;82785;194.0;2015;True;45;7.112113402061856
141.0;Ridly István Attila;1981;M2;HUN;Négy Égtáj SE;Nyergesújfalu;M;122;F2/45;5829;6363;7349;19541;6528;6834;10152;23514;5141;6757;5627;17525;6095;9615;6557;22267;82847;194.0;2015;True;34;7.117439862542955
26.0;Dessers Beáta;1972;F3;HUN;-;Budapest;F;139;N3/15;6026;6736;6976;19738;6583;6945;9917;23445;5266;6883;5863;18012;6098;8699;6955;21752;82947;194.0;2015;True;43;7.1260309278350515
142.0;Sólyom Zoltán;1972;M3;HUN;Ikarus BSE;Budapest;M;151;F3/84;5975;6597;7093;19665;0;13413;9832;23245;5211;7714;5592;18517;6037;9427;6957;22421;83848;194.0;2015;True;43;7.203436426116839
143.0;Árgyelán Krisztián;1976;M2;HUN;Fősör FC;Kétegyháza;M;179;F2/46;5917;6657;6768;19342;6447;6787;9182;22416;5429;7769;5729;18927;6032;9435;7835;23302;83987;194.0;2015;True;39;7.215378006872852
144.0;Iváncsics Zsolt;1968;M3;HUN;EMU;Orosháza;M;256;F3/85;5919;6623;7244;19786;6418;6658;9937;23013;5205;7568;6011;18784;6134;9613;6711;22458;84041;194.0;2015;True;47;7.220017182130585
145.0;Acsádi Lajos;1972;M3;HUN;-;Nádudvar;M;172;F3/86;6197;6446;7094;19737;6630;6597;9799;23026;5674;7795;6191;19660;6351;9015;6386;21752;84175;194.0;2015;True;43;7.231529209621994
146.0;Vass János;1967;M3;HUN;-;Budapest;M;269;F3/87;5830;6419;7352;19601;6278;6665;10627;23570;5258;7669;6623;19550;5704;8746;7018;21468;84189;194.0;2015;True;48;7.232731958762887
147.0;Blücher, Tord;1958;M4;SWE;-;Stora;M;429;F4/11;5702;6290;7077;19069;6058;6336;10405;22799;5353;7629;6328;19310;6121;9611;7425;23157;84335;194.0;2015;True;57;7.245274914089347
148.0;Noa, Frank;1962;M4;GER;Rennsteig Laufverein;Olbernhau;M;408;F3/88;0;12589;6831;19420;6447;6766;9632;22845;5405;7710;6186;19301;6098;9579;7222;22899;84465;194.0;2015;True;53;7.256443298969073
27.0;Noa, Heike;1964;F3;GER;Rennsteig Laufverein;Olbernhau;F;409;N3/16;0;0;19420;19420;6450;6767;9634;22851;5401;7711;6188;19300;6099;9577;7221;22897;84468;194.0;2015;True;51;7.256701030927835
149.0;Berzi Zoltán;1982;M2;HUN;-;Ajka;M;104;F2/47;5988;6521;7455;19964;6414;7015;10229;23658;5646;7800;6266;19712;6034;9156;7049;22239;85573;194.0;2015;True;33;7.351632302405498
150.0;Balogh Ádám;1979;M2;HUN;BKV Előre SC;Budapest;M;276;F2/48;5721;5467;7045;18233;6503;7441;10434;24378;5626;8756;6673;21055;5264;8273;8433;21970;85636;194.0;2015;True;36;7.3570446735395185
151.0;Bartl János;1975;M3;HUN;-;Dorog;M;339;F2/49;5091;5916;8188;19195;6176;7501;10556;24233;4972;7887;6640;19499;5907;9675;7259;22841;85768;194.0;2015;True;40;7.368384879725086
152.0;Keresztes János;1966;M3;HUN;-;Budapest;M;299;F3/89;6106;6673;7273;20052;6421;6822;9511;22754;5754;7978;5949;19681;6421;9547;7519;23487;85974;194.0;2015;True;49;7.3860824742268045
153.0;Timkó Zoltán;1954;M5;HUN;BDSE;Budaörs;M;152;F4/12;6118;6476;7071;19665;6846;7495;10385;24726;5566;8018;5944;19528;6043;9429;6965;22437;86356;194.0;2015;True;61;7.418900343642612
28.0;Sebestyén Linda;1980;F2;HUN;SZUFLA;Budapest;F;154;N2/12;6193;7060;7573;20826;6395;7483;9888;23766;5429;8336;6268;20033;6110;9687;6867;22664;87289;194.0;2015;True;35;7.499054982817869
154.0;Szigeti Attila;1970;M3;HUN;-;Siófok;M;102;F3/90;5830;6743;8821;21394;6704;7262;10971;24937;5527;7229;6041;18797;6375;8989;6812;22176;87304;194.0;2015;True;45;7.500343642611684
155.0;Fazekas János;1968;M3;HUN;Vasemberek Klubja;Budapest;M;131;F3/91;6180;6524;7493;20197;6852;6921;10601;24374;5560;8031;6348;19939;6300;9693;7539;23532;88042;194.0;2015;True;47;7.563745704467354
156.0;Jánosi Kornél dr.;1964;M4;HUN;Buda Fitness;Szentendre;M;127;F3/92;5997;6706;7498;20201;6848;6916;10611;24375;5564;8018;6359;19941;6302;9693;7540;23535;88052;194.0;2015;True;51;7.564604810996563
157.0;Havalda László;1971;M3;HUN;-;Budapest;M;268;F3/93;6106;6759;7812;20677;6562;7057;9905;23524;5607;7661;6465;19733;6697;9886;8433;25016;88950;194.0;2015;True;44;7.641752577319588
158.0;Zab Róbert;1969;M3;HUN;Fuszekli;Kaposvár;M;153;F3/94;6197;6875;7018;20090;7303;7476;9647;24426;5688;8350;5975;20013;6336;10262;7977;24575;89104;194.0;2015;True;46;7.654982817869415
29.0;Pallósné Szilágyi Katalin;1971;F3;HUN;-;Isaszeg;F;320;N3/17;6228;7254;7703;21185;6963;7665;10334;24962;5808;8009;6224;20041;6435;9481;7093;23009;89197;194.0;2015;True;44;7.662972508591065
159.0;Ajkay Antal;1950;M5;HUN;Sárvár Kinizsi SE;Budapest;M;110;F4/13;6242;0;14950;21192;6998;7626;10342;24966;5806;8005;6227;20038;6435;9509;7075;23019;89215;194.0;2015;True;65;7.664518900343643
160.0;Hack Román Antal;1974;M3;HUN;Hack-i mer az nyer;Nyergesújfalu;M;25;F3/95;5682;6857;8463;21002;6200;7471;10718;24389;5346;9131;6821;21298;5547;9977;7432;22956;89645;194.0;2015;True;41;7.701460481099656
30.0;Paraniak, Barbro;1956;F4;SWE;-;Huddninge;F;424;N4/1;6167;6760;8029;20956;6646;6943;11022;24611;5599;7833;6880;20312;6184;9781;8089;24054;89933;194.0;2015;True;59;7.726202749140894
161.0;Kiss Attila;1981;M2;HUN;-;Hódmezővásárhely;M;180;F2/50;6076;6686;8570;21332;6706;7123;10823;24652;5628;8280;6570;20478;6383;9773;8154;24310;90772;194.0;2015;True;34;7.798281786941581
31.0;Csibor Anita;1989;F1;HUN;-;Békés;F;312;N2/13;5894;7606;8240;21740;6837;7668;10630;25135;5724;8757;6672;21153;6741;11037;8127;25905;93933;194.0;2015;True;26;8.069845360824742
32.0;Regősné Kiss Edit;1962;F3;HUN;Futakeszi;Dunakeszi;F;116;N3/18;6176;7389;8173;21738;6787;7865;10758;25410;5842;9565;6862;22269;7119;11289;8143;26551;95968;194.0;2015;True;53;8.244673539518901
33.0;Berzy Judith;1973;F3;HUN;-;Budapest;F;22;N3/19;6223;7456;8368;22047;6955;7880;11451;26286;5857;9055;7114;22026;6424;11074;8339;25837;96196;194.0;2015;True;42;8.264261168384879
999.0;Mester Gábor;1978;M2;HUN;-;Győr;M;162;;5432;5482;6725;17639;5747;6122;9424;21293;0;0;0;0;0;0;0;0;38932;101.0;2015;False;37;6.424422442244224
999.0;Sándor Miklós;1975;M3;HUN;-;Szolnok;M;354;;6020;6747;8017;20784;6622;8014;11762;26398;5828;9188;0;15016;6720;12670;1850;21240;83438;150.0;2015;False;40;9.270888888888889
999.0;Homoki László;1982;M2;HUN;-;Budapest;M;165;;5418;6223;7357;18998;0;0;0;0;0;0;0;0;0;0;0;0;18998;48.0;2015;False;33;6.596527777777777
999.0;Ladányi Róbert;1954;M5;HUN;Óbudai Futókör;Budapest;M;252;;5089;5299;5346;15734;0;0;0;0;0;0;0;0;0;0;0;0;15734;48.0;2015;False;61;5.4631944444444445
999.0;Kiss György;1935;M5;HUN;-;Dunakeszi;M;1935;;0;0;0;0;6789;7868;11385;26042;5725;9629;6856;22210;7120;11294;8140;26554;74806;141.0;2015;False;80;8.842316784869976
999.0;Kovács Nóra dr.;1970;F3;HUN;-;Budapest;F;138;;5665;6162;6746;18573;6371;6587;9640;22598;0;0;0;0;0;0;0;0;41171;101.0;2015;False;45;6.793894389438943
999.0;Raiser, Carsten Dr.;1973;M3;GER;-;Stuttgart;M;431;;5411;5806;6615;17832;5864;6298;9329;21491;0;0;0;0;0;0;0;0;39323;101.0;2015;False;42;6.488943894389439
999.0;Paraniak, Jan;1950;M5;SWE;-;Huddninge;M;423;;5342;6097;8394;19833;0;0;0;0;0;0;0;0;4658;7595;6234;18487;38320;97.0;2015;False;65;6.584192439862543
999.0;Erdélyi Attila;1986;M2;HUN;Futobarátok;Csorna;M;334;;4974;5008;5082;15064;5198;5199;7093;17490;0;0;0;0;0;0;0;0;32554;101.0;2015;False;29;5.371947194719472
999.0;Baranyai Máté;1978;M2;HUN;Balatonfüredi Futó Cimborák & Barátaik;Balatonszőlős;M;360;;0;0;0;0;9764;0;0;9764;0;0;0;0;0;0;0;0;9764;15.0;2015;False;37;10.848888888888888
999.0;Joachim, Burgard;1980;M2;GER;-;Stuttgart;M;435;;4653;5003;5798;15454;5381;5437;9436;20254;5102;6820;5359;17281;0;0;0;0;52989;145.0;2015;False;35;6.0906896551724135
999.0;Gavelfaelt, Niklas;1977;M2;SWE;Club Running Sweden;Kungsängen;M;433;;4183;4251;4279;12713;4490;4381;6192;15063;0;0;0;0;0;0;0;0;27776;101.0;2015;False;38;4.583498349834984
999.0;Gusztos Péter;1976;M2;HUN;SUHANJ!;Budapest;M;111;;5319;5758;6227;17304;0;0;0;0;0;0;0;0;0;0;0;0;17304;48.0;2015;False;39;6.008333333333333
999.0;Oel, Gottfried;1959;M4;GER;LLC Marathon Regensburg;Bruchsal;M;434;;5493;0;13541;19034;6274;6503;9442;22219;5122;7431;6088;18641;0;0;0;0;59894;145.0;2015;False;56;6.884367816091954
999.0;Kiss Attila;1997;M1;HUN;-;Gyöngyös;M;129;;5378;5414;6423;17215;0;0;0;0;0;0;0;0;0;0;0;0;17215;48.0;2015;False;18;5.977430555555556
1.0;Steib Péter;1980;M2;HUN;SZUFLA;Szigetszentmárton;M;263;F2/1;3735;4044;4044;11823;3938;3960;5307;13205;3296;4311;6403;14010;4023;4911;3594;12528;51566;195.0;2014;True;34;4.407350427350427
2.0;Strosny, Rene;1973;M3;GER;Läuferherz Darmstadt;Modautal;M;417;F3/1;3858;4515;4515;12888;4080;4175;5905;14160;3399;4467;6873;14739;4246;5365;4204;13815;55602;195.0;2014;True;41;4.752307692307692
3.0;Cserpák Tamás;1978;M2;HUN;Nike Futócenter Nyíregyháza;Nyíregyháza;M;159;F2/2;4667;4931;4931;14529;4843;4678;6460;15981;3898;4923;7583;16404;4696;5606;4075;14377;61291;195.0;2014;True;36;5.238547008547008
4.0;Havasi György;1973;M3;HUN;Hírös Pockok HSE;Kecskemét;M;254;F3/2;4420;5114;5114;14648;4701;4634;6570;15905;3761;4943;7650;16354;4503;5615;4402;14520;61427;195.0;2014;True;41;5.25017094017094
5.0;To, Chi Shing;1972;M3;HKG;-;;M;406;F3/3;4295;5362;5362;15019;4726;4727;7247;16700;3746;4786;7499;16031;4501;5623;4829;14953;62703;195.0;2014;True;42;5.359230769230769
6.0;Csécsei Zoltán;1984;M2;HUN;Szufla SE;Marcali;M;158;F2/3;4421;5074;5074;14569;4857;4670;6490;16017;3906;5076;7938;16920;4797;5843;4311;14951;62457;195.0;2014;True;30;5.338205128205129
7.0;Prüfer, Gaston;1978;M2;GER;LG Mauerweg Berlin e.V.;Berlin;M;473;F2/4;4623;5298;5298;15219;4814;4717;6766;16297;3939;5035;7776;16750;4634;5751;4307;14692;62958;195.0;2014;True;36;5.381025641025641
8.0;Tóth Csaba;1973;M3;HUN;-;Budapest;M;138;F3/4;4685;5063;5063;14811;4721;4813;7030;16564;3857;5028;7663;16548;4559;5725;4510;14794;62717;195.0;2014;True;41;5.36042735042735
9.0;Morar, Horatiu;1975;M2;ROM;Runners Club;CLUJ NAPOCA;M;171;F2/5;4803;5071;5071;14945;5089;4885;6688;16662;3912;4977;7706;16595;4858;5690;4063;14611;62813;195.0;2014;True;39;5.368632478632479
10.0;Lindenbeck, Christof;1962;M4;GER;Stolpertruppe Winsen Südsektion;Freiburg;M;437;F3/5;4929;5132;5132;15193;4983;4847;6539;16369;4001;4941;7712;16654;4616;5720;4392;14728;62944;195.0;2014;True;52;5.37982905982906
11.0;Kelm, Timo;1983;M2;GER;asphalt-junkie;neustadt in holstein;M;420;F2/6;4919;5149;5149;15217;4981;4849;6565;16395;3985;4953;7801;16739;4580;5753;4596;14929;63280;195.0;2014;True;31;5.408547008547009
1.0;Tigyiné Görög Veronika;1981;F2;HUN;Keszthelyi Kilométerek;Keszthely;F;265;N2/1;4614;4893;4893;14400;4938;4970;6723;16631;4076;5134;7947;17157;4934;6045;4384;15363;63551;195.0;2014;True;33;5.431709401709402
12.0;Frankó Vilmos;1968;M3;HUN;-;Békéscsaba;M;153;F3/6;4651;5380;5380;15411;4805;4854;6725;16384;3918;5028;7766;16712;4855;5958;4521;15334;63841;195.0;2014;True;46;5.456495726495726
13.0;Meers, Vincent;1973;M3;BEL;RC Gent;Gentbrugge;M;434;F3/7;4795;4878;4878;14551;4791;4808;6586;16185;3824;4960;7766;16550;4929;6347;4850;16126;63412;195.0;2014;True;41;5.419829059829059
14.0;Roskovics Miklós;1970;M3;HUN;-;Érd;M;172;F3/8;4685;0;0;4685;4765;4761;6898;16424;3804;4971;7875;16650;4921;6178;4642;15741;53500;195.0;2014;True;44;4.572649572649572
15.0;Rokob József;1978;M2;HUN;-;Győr;M;155;F2/7;4527;5540;5540;15607;4934;5386;7003;17323;4124;5233;8166;17523;5314;6353;4480;16147;66600;195.0;2014;True;36;5.6923076923076925
16.0;Bakó Gábor;1968;M3;HUN;-;Budakalász;M;168;F3/9;4788;5192;5192;15172;4767;5128;7731;17626;3842;5579;8068;17489;4942;6259;5246;16447;66734;195.0;2014;True;46;5.703760683760684
17.0;Papp Sándor;1970;M3;HUN;Debreceni Rendőr SE;Vámospércs;M;244;F3/10;4662;5341;5341;15344;5126;5077;7705;17908;4112;5408;8264;17784;4988;6244;4839;16071;67107;195.0;2014;True;44;5.7356410256410255
18.0;Kaluz Ákos Bertalan;1981;M2;HUN;-;Seregélyes;M;117;F2/8;4949;5851;5851;16651;0;0;7231;7231;4102;5149;8185;17436;5079;6350;5201;16630;57948;195.0;2014;True;33;4.952820512820512
19.0;Geréd László ifj.;1970;M3;HUN;-;Balatonalmádi;M;282;F3/11;5195;5511;5511;16217;5297;5211;7198;17706;4211;0;0;4211;5007;6243;4673;15923;54057;195.0;2014;True;44;4.6202564102564105
20.0;Salamon István;1962;M4;HUN;-;Mezőtárkány;M;34;F3/12;5148;5790;5790;16728;5190;5241;7401;17832;4010;5346;8135;17491;4921;6234;4814;15969;68020;195.0;2014;True;52;5.813675213675214
21.0;Wereszczak, Andrzej;1977;M2;POL;-;Żory;M;404;F2/9;5101;5284;5284;15669;5266;5146;7034;17446;4348;0;0;4348;5275;6446;4855;16576;54039;195.0;2014;True;37;4.618717948717949
22.0;Szabó László;1957;M4;HUN;Alföld TE;Mezőberény;M;225;F4/1;4820;5339;5339;15498;5189;5094;7337;17620;4157;5620;8530;18307;5132;6451;5058;16641;68066;195.0;2014;True;57;5.817606837606838
23.0;Szántó Árpád;1974;M3;HUN;-;Kecskemét;M;181;F2/10;5040;5057;5057;15154;4557;5558;6613;16728;3832;5781;8034;17647;5225;7309;5003;17537;67066;195.0;2014;True;40;5.732136752136752
24.0;Járosi Tamás;1973;M3;HUN;Zebra Futóklub;Budapest;M;101;F3/13;4371;5533;5533;15437;4645;5058;7754;17457;3901;5559;8354;17814;5001;7199;5361;17561;68269;195.0;2014;True;41;5.834957264957264
25.0;Muzhetckii, Nikolai;1960;M4;RUS;-;Sochi;M;432;F3/14;5167;5633;5633;16433;5375;5366;7273;18014;4162;5497;8390;18049;4960;6132;4799;15891;68387;195.0;2014;True;54;5.8450427350427345
26.0;Márkus István;1972;M3;HUN;Kadarka Futóegyesület;Szekszárd;M;264;F3/15;4814;5254;5254;15322;5132;5349;8044;18525;4106;5252;8374;17732;5120;6382;5304;16806;68385;195.0;2014;True;42;5.8448717948717945
27.0;Simon Zoltán;1970;M3;HUN;-;Solymár;M;37;F3/16;5146;5771;5771;16688;5437;5203;7078;17718;4285;5469;8417;18171;5499;6545;4857;16901;69478;195.0;2014;True;44;5.938290598290599
28.0;Kurucz András;1980;M2;HUN;Angyalcipők;Budapest;M;132;F2/11;5097;5101;5101;15299;5252;5081;7268;17601;4374;5651;8723;18748;5497;6755;5003;17255;68903;195.0;2014;True;34;5.8891452991453
29.0;Mészáros Zoltán;1964;M3;HUN;Spuri SC;Budapest;M;222;F3/17;4753;6012;6012;16777;5161;5474;7454;18089;4261;5648;8679;18588;5143;6479;5046;16668;70122;195.0;2014;True;50;5.993333333333333
30.0;Kovács Imre;1993;M1;HUN;Knorr-Bremse;Szigethalom;M;247;F1/1;6026;6752;6752;19530;4900;4572;6972;16444;3798;5075;7950;16823;4965;6739;4738;16442;69239;195.0;2014;True;21;5.917863247863248
31.0;Notheisz János;1977;M2;HUN;-;Jászberény;M;146;F2/12;4792;5661;5661;16114;5256;5319;7606;18181;4450;0;0;4450;5530;6573;4596;16699;55444;195.0;2014;True;37;4.738803418803419
32.0;Czaltig Zsolt;1974;M3;HUN;-;Lajoskomárom;M;131;F2/13;5135;6091;6091;17317;5367;5156;7191;17714;4230;5412;8432;18074;4987;6551;5365;16903;70008;195.0;2014;True;40;5.983589743589743
33.0;Tigyi László;1960;M4;HUN;BFC Futapest;Budapest;M;202;F3/18;4612;5603;5603;15818;5200;6244;8681;20125;3925;0;0;3925;5058;6536;5149;16743;56611;195.0;2014;True;54;4.838547008547009
34.0;Windisch, Ralf;1969;M3;GER;Therme LT Böblingen;Grafenau;M;415;F3/19;5381;5883;5883;17147;5398;5312;7531;18241;4218;5481;8500;18199;5144;6481;4861;16486;70073;195.0;2014;True;45;5.989145299145299
2.0;Máténé Varju Edit;1971;F3;HUN;EMU;Székesfehérvár;F;246;N3/1;4755;5864;5864;16483;5025;5363;7244;17632;4268;5932;8798;18998;5069;6777;5316;17162;70275;195.0;2014;True;43;6.006410256410256
35.0;Kudrin, Vasily;1978;M2;RUS;-;Moscow;M;435;F2/14;5435;5589;5589;16613;5890;5613;7658;19161;4269;5580;8541;18390;5180;6346;4954;16480;70644;195.0;2014;True;36;6.037948717948718
36.0;Nagy Imre;1981;M2;HUN;Záróbusz Felvezetők ESK;Egyek;M;182;F2/15;4980;5549;5549;16078;5215;5417;7745;18377;3475;5078;7991;16544;4956;7097;6460;18513;69512;195.0;2014;True;33;5.941196581196581
37.0;Hergovics Gábor;1965;M3;HUN;Szondi SE;Székesfehérvár;M;278;F3/20;4760;5612;5612;15984;5233;5504;7821;18558;4331;5502;8653;18486;5529;6646;5604;17779;70807;195.0;2014;True;49;6.0518803418803415
38.0;Köves Péter;1972;M3;HUN;Kanizsai Futóklub;Nagykanizsa;M;107;F3/21;5461;5789;5789;17039;5295;5379;7646;18320;4333;5950;8804;19087;5305;0;0;5305;59751;195.0;2014;True;42;5.106923076923077
39.0;Klebercz Tamas;1973;M3;HUN;-;Vác;M;173;F3/22;4700;5592;5592;15884;5179;5452;8739;19370;4109;5683;8519;18311;5120;7136;5573;17829;71394;195.0;2014;True;41;6.102051282051282
40.0;Kerekes László;1967;M3;HUN;-;Szekszárd;M;170;F3/23;5144;5907;5907;16958;5406;5418;7052;17876;4265;5619;8612;18496;5996;7112;5271;18379;71709;195.0;2014;True;47;6.128974358974359
41.0;De Prest, Mathias;1978;M2;BEL;LG Mauerweg Berlin e.V.;Berlin;M;482;F2/16;5126;5685;5685;16496;5670;5594;7525;18789;4505;5976;9093;19574;5350;6710;4867;16927;71786;195.0;2014;True;36;6.135555555555555
3.0;Enyediné Dobai Henriett;1977;F2;HUN;-;Ebes;F;281;N2/2;4889;5829;5829;16547;5469;5500;7431;18400;4430;6035;9062;19527;5419;7074;5280;17773;72247;195.0;2014;True;37;6.174957264957264
42.0;Pók János;1963;M4;HUN;Axiál Kft.;Gárdony (Agárd);M;33;F3/24;4956;5655;5655;16266;5506;5578;7664;18748;4519;6122;9109;19750;5528;6841;5278;17647;72411;195.0;2014;True;51;6.188974358974359
43.0;Darányi János;1963;M4;HUN;-;Soltvadkert;M;206;F3/25;4879;5352;5352;15583;5023;5218;7553;17794;4318;6222;9062;19602;5670;7398;5958;19026;72005;195.0;2014;True;51;6.154273504273504
4.0;Tóth Jutka;1973;F3;HUN;Futóbarátok - Nike Futóklub Győr;Lovászpatona;F;235;N3/2;5178;5524;5524;16226;5414;5608;7639;18661;4274;6040;8890;19204;5396;7218;5328;17942;72033;195.0;2014;True;41;6.156666666666666
44.0;Adamenko, Ivan Dr.;1979;M2;RUS;KLB Ural-100;Ekaterinburg;M;424;F2/17;5302;6335;6335;17972;5804;5613;7709;19126;4528;5829;8928;19285;5227;6557;5085;16869;73252;195.0;2014;True;35;6.260854700854701
45.0;Sipos Sándor;1957;M4;HUN;HASE;Budapest;M;249;F4/2;5171;5959;5959;17089;5478;5344;7641;18463;4422;5803;8999;19224;5484;7094;5395;17973;72749;195.0;2014;True;57;6.217863247863248
46.0;Lukovics Béla;1953;M5;HUN;Békéscsabai AC;Békéscsaba;M;58;F4/3;5123;5526;5526;16175;5433;5530;7990;18953;4635;5948;9150;19733;5661;7073;5349;18083;72944;195.0;2014;True;61;6.234529914529914
47.0;Dovala, Adrian;1975;M2;SVK;Drnava;Drnava;M;413;F2/18;5138;5708;5708;16554;5614;5541;7714;18869;4525;6022;9322;19869;5719;7079;5149;17947;73239;195.0;2014;True;39;6.25974358974359
5.0;Vida Beáta;1979;F2;HUN;Ironteam SE;Tatabánya;F;243;N2/3;5504;5790;5790;17084;5649;5491;7632;18772;4572;5839;9105;19516;5558;6895;5275;17728;73100;195.0;2014;True;35;6.247863247863248
48.0;Földesi József;1957;M4;HUN;Tapolca Honvéd SE;Tapolca;M;275;F4/4;5312;5708;5708;16728;5591;5613;7804;19008;4692;6158;9510;20360;5774;7258;5642;18674;74770;195.0;2014;True;57;6.390598290598291
6.0;Plavecz Andrea;1978;F2;HUN;-;Békéscsaba;F;267;N2/4;5328;6013;6013;17354;5645;5803;8370;19818;4565;6094;9264;19923;5406;6903;5371;17680;74775;195.0;2014;True;36;6.391025641025641
49.0;Fejes Zoltán;1974;M3;HUN;-;Békéscsaba;M;260;F2/19;5342;6012;6012;17366;5641;5816;8362;19819;4561;6096;9261;19918;5403;6908;5370;17681;74784;195.0;2014;True;40;6.391794871794872
50.0;Soós Péter;1970;M3;HUN;Honvéd Szondi SE;Székesfehérvár;M;279;F3/26;5508;5810;5810;17128;5649;5504;8179;19332;4578;6337;9294;20209;5953;6936;5020;17909;74578;195.0;2014;True;44;6.374188034188034
51.0;Kertész Ervin;1970;M3;HUN;Nike Futóklub - Győr;Ásványráró;M;121;F3/27;4483;5839;5839;16161;5294;5953;8199;19446;4228;5736;9177;19141;5738;8224;6638;20600;75348;195.0;2014;True;44;6.4399999999999995
52.0;Horváth Bálint;1981;M2;HUN;-;Rum;M;161;F2/20;5020;0;0;5020;5619;5904;8246;19769;4435;0;0;4435;5574;7408;5580;18562;47786;195.0;2014;True;33;4.084273504273504
53.0;Szűcs Lajos;1974;M3;HUN;-;Veresegyház;M;209;F3/28;5143;6182;6182;17507;5924;6027;8124;20075;4671;6443;9406;20520;5739;7035;4742;17516;75618;195.0;2014;True;40;6.4630769230769225
54.0;Keresztesi László;1965;M3;HUN;Jászberényi Triatlon;Jászberény;M;214;F3/29;4793;7410;7410;19613;5275;5219;7733;18227;4392;6247;9965;20604;5811;7362;5136;18309;76753;195.0;2014;True;49;6.56008547008547
7.0;Gyűrűs Nóra;1979;F2;HUN;Honvéd Szondi SE;Székesfehérvár;F;271;N2/5;4657;5965;5965;16587;5292;5729;8307;19328;4432;6275;10126;20833;5822;7660;5677;19159;75907;195.0;2014;True;35;6.487777777777778
55.0;Vogl Péter;1966;M3;HUN;-;Tordas;M;251;F3/30;5222;9233;9233;23688;6022;5709;7135;18866;4469;5745;8819;19033;5407;6709;4938;17054;78641;195.0;2014;True;48;6.721452991452992
56.0;Vörös Miklós;1965;M3;HUN;SUHANJ!;Budapest;M;134;F3/31;5475;5957;5957;17389;5490;6277;8388;20155;4299;6259;8990;19548;5535;7438;5658;18631;75723;195.0;2014;True;49;6.472051282051281
57.0;Tóth Iván Csaba;1974;M3;HUN;Vasemberek Klubja;Fót;M;174;F2/21;5140;6182;6182;17504;5922;6029;8206;20157;4669;6358;9491;20518;5739;7071;5295;18105;76284;195.0;2014;True;40;6.5200000000000005
58.0;Nedeczky László Tamás;1984;M2;HUN;-;Budapest;M;220;F2/22;5314;6731;6731;18776;5789;5518;7924;19231;4564;0;0;4564;5666;7426;5341;18433;61004;195.0;2014;True;30;5.214017094017094
59.0;Túri Márton;1992;M1;HUN;-;Paks;M;126;F1/2;4595;7401;7401;19397;5364;5742;9244;20350;4582;6442;9350;20374;5415;7243;5446;18104;78225;195.0;2014;True;22;6.685897435897436
60.0;Kucsera Márton;1973;M3;HUN;MAFC;Budapest;M;262;F3/32;5244;6278;6278;17800;5343;5649;8232;19224;4516;6272;9617;20405;5677;0;0;5677;63106;195.0;2014;True;41;5.3936752136752135
61.0;Scheffer István;1960;M4;HUN;PAFF;Paks;M;273;F3/33;4730;7402;7402;19534;5592;5753;8781;20126;4571;6430;9349;20350;5416;7242;5451;18109;78119;195.0;2014;True;54;6.676837606837607
62.0;Ladányi Róbert;1954;M5;HUN;Óbudai Futókör;Budapest;M;223;F4/5;5443;6062;6062;17567;5922;6026;8295;20243;4759;6419;9642;20820;5909;7243;5198;18350;76980;195.0;2014;True;60;6.579487179487179
63.0;Sorbán András dr.;1968;M3;HUN;-;Budapest;M;178;F3/34;5955;6704;6704;19363;5866;5659;6381;17906;4776;6457;9701;20934;5966;7664;6083;19713;77916;195.0;2014;True;46;6.659487179487179
64.0;Schepers, Joeri;1971;M3;BEL;JC Aalter;Aalter;M;436;F3/35;5663;5880;5880;17423;6030;5931;8011;19972;4880;6452;9461;20793;6264;7775;5539;19578;77766;195.0;2014;True;43;6.6466666666666665
8.0;Solti Beáta;1976;F2;HUN;-;Budakalász;F;272;N2/6;5543;6263;6263;18069;5852;5961;8270;20083;4627;0;0;4627;6208;7380;5543;19131;61910;195.0;2014;True;38;5.291452991452991
65.0;Nagy Zsolt;1980;M2;HUN;-;Budapest;M;284;F2/23;5346;6133;6133;17612;5618;6096;9132;20846;4566;6336;9756;20658;5539;7512;6080;19131;78247;195.0;2014;True;34;6.687777777777777
9.0;Csákány Krisztina;1971;F3;HUN;Futóbarátok Egyesület;Győrújbarát;F;208;N3/3;5515;6291;6291;18097;5900;6088;8293;20281;4863;6380;9647;20890;5821;7513;5799;19133;78401;195.0;2014;True;43;6.7009401709401715
66.0;Hegedűs József;1963;M4;HUN;FFTC;Dunaföldvár;M;229;F3/36;5232;6154;6154;17540;5754;6064;8606;20424;4727;6427;9790;20944;5958;7710;5973;19641;78549;195.0;2014;True;51;6.713589743589744
67.0;Simon Péter;1965;M3;HUN;-;Budapest;M;252;F3/37;4798;7035;7035;18868;5740;5936;8533;20209;4560;6278;9535;20373;5561;7800;6116;19477;78927;195.0;2014;True;49;6.745897435897436
68.0;Tálas Krisztián dr.;1976;M2;HUN;-;Szabadbattyán;M;165;F2/24;4656;6669;6669;17994;5629;6093;8536;20258;4472;0;0;4472;5839;8451;6203;20493;63217;195.0;2014;True;38;5.403162393162392
69.0;Frank Tibor;1949;M5;HUN;EMU;Budapest;M;250;F4/6;5214;6776;6776;18766;5977;5974;8361;20312;4257;5642;8525;18424;6251;8307;6500;21058;78560;195.0;2014;True;65;6.714529914529914
10.0;Zsupányi Adrienn;1985;F2;HUN;Honvéd Szondi SE;Székesfehérvár;F;280;N2/7;5506;6522;6522;18550;6067;5763;8125;19955;4799;6413;9724;20936;5963;7683;6062;19708;79149;195.0;2014;True;29;6.764871794871795
70.0;Szőke Tamás;1970;M3;HUN;Honvéd Szondi SE;Székesfehérvár;M;14;F3/38;5509;6526;6526;18561;6066;5767;8121;19954;4801;6425;9716;20942;5962;7684;6073;19719;79176;195.0;2014;True;44;6.767179487179487
71.0;Huszty Béla;1964;M3;HUN;Kalocsai Földön Futók;Kalocsa;M;218;F3/39;5575;7634;7634;20843;5898;5855;8168;19921;4762;6265;9379;20406;5817;7625;5302;18744;79914;195.0;2014;True;50;6.8302564102564105
72.0;Schmidt Norbert;1985;M2;HUN;-;Budapest;M;164;F2/25;4976;6485;6485;17946;5921;6845;8231;20997;4638;6939;9403;20980;5966;7794;5848;19608;79531;195.0;2014;True;29;6.797521367521368
73.0;Hogya Dénes;1981;M2;HUN;-;Miskolc (Szirma);M;144;F2/26;5412;7587;7587;20586;6350;6515;9122;21987;4482;6276;9238;19996;5595;7074;5133;17802;80371;195.0;2014;True;33;6.869316239316239
74.0;Sebestyén Gyula;1980;M2;HUN;-;Érd;M;269;F2/27;5447;6186;6186;17819;5814;6015;8706;20535;4868;6511;10105;21484;6244;7712;5765;19721;79559;195.0;2014;True;34;6.79991452991453
75.0;Saronja, Zeljko;1969;M3;CRO;-;Zagreb;M;423;F3/40;5737;0;0;5737;5884;5881;8712;20477;4696;6376;9808;20880;5954;7599;5776;19329;66423;195.0;2014;True;45;5.677179487179487
76.0;Horváth Péter;1968;M3;HUN;-;Szombathely;M;268;F3/41;5442;6187;6187;17816;5818;6005;8720;20543;4865;6517;10094;21476;6241;7717;5765;19723;79558;195.0;2014;True;46;6.79982905982906
77.0;Blaskó Mihály;1980;M2;HUN;-;Budapest;M;287;F2/28;5251;6534;6534;18319;5898;6288;8664;20850;4739;6470;9735;20944;6067;7825;6115;20007;80120;195.0;2014;True;34;6.8478632478632475
78.0;Szabó Zoltán dr;1958;M4;HUN;-;Dunaújváros;M;231;F3/42;5134;6697;6697;18528;5827;6010;8047;19884;4734;0;0;4734;6443;7496;6218;20157;63303;195.0;2014;True;56;5.41051282051282
79.0;Boerenkamp, Rainer;1960;M4;GER;-;Nettetal;M;402;F3/43;5850;6317;6317;18484;6279;6070;8167;20516;4975;6504;9881;21360;6220;7538;5532;19290;79650;195.0;2014;True;54;6.8076923076923075
80.0;Krabácz Miklós;1959;M4;HUN;Buda Fitness;Budapest;M;124;F3/44;5726;6177;6177;18080;5856;6273;9033;21162;4796;6509;9780;21085;5863;7745;5422;19030;79357;195.0;2014;True;55;6.782649572649572
81.0;Gaeckle, Andreas;1966;M3;GER;-;Markgroeningen;M;418;F3/45;5638;6409;6409;18456;5967;6222;9119;21308;4828;6481;9825;21134;5973;7779;5275;19027;79925;195.0;2014;True;48;6.831196581196581
82.0;Vasas Levente;1981;M2;HUN;-;Kecskemét;M;119;F2/29;5433;6427;6427;18287;5951;6062;8489;20502;4974;6551;9877;21402;6155;8154;5944;20253;80444;195.0;2014;True;33;6.875555555555556
83.0;Kreszta Zoltán;1970;M3;HUN;-;Budapest;M;11;F3/46;5817;6604;6604;19025;5626;5692;10036;21354;4860;6415;9808;21083;5789;7791;5869;19449;80911;195.0;2014;True;44;6.915470085470085
11.0;Balke, Cornelia;1965;F3;GER;LG Mauerweg Berlin e.V.;Berlin;F;412;N3/4;5239;7806;7806;20851;5856;5965;8754;20575;4414;6335;9419;20168;5832;7795;6051;19678;81272;195.0;2014;True;49;6.946324786324786
84.0;Rohwedder, Karl;1955;M4;GER;100 Marathon Club;Braunschweig;M;411;F4/7;5240;7794;7794;20828;5860;5970;8747;20577;4414;6344;9410;20168;5836;7862;5981;19679;81252;195.0;2014;True;59;6.944615384615385
85.0;Séra István;1960;M4;HUN;Futóbolondok SE;Budapest;M;36;F3/47;4759;6888;6888;18535;5723;6796;9292;21811;4647;6843;9943;21433;5760;7509;5676;18945;80724;195.0;2014;True;54;6.89948717948718
86.0;Pintér Sándor;1975;M2;HUN;Pénzügyőr SE;Gödöllő;M;238;F2/30;5026;5403;5403;15832;5346;6114;9179;20639;4964;7717;10684;23365;6693;8503;5438;20634;80470;195.0;2014;True;39;6.877777777777778
87.0;Tóth Gábor;1967;M3;HUN;Futóbarátok - Nike Futóklub Győr;Ikrény;M;236;F3/48;5218;6314;6314;17846;5891;6099;9329;21319;4830;7023;9921;21774;5992;8077;6046;20115;81054;195.0;2014;True;47;6.9276923076923085
88.0;Von Uleniecki, Alexander;1968;M3;GER;LG Mauerweg Berlin e.V.;Berlin;M;421;F3/49;6049;6841;6841;19731;6352;6136;7957;20445;4850;6502;9869;21221;6191;7714;5889;19794;81191;195.0;2014;True;46;6.93940170940171
89.0;Svanda Zoltán;1966;M3;HUN;-;Békéscsaba;M;185;F3/50;5689;6258;6258;18205;5789;6018;8724;20531;4795;6900;10802;22497;5940;7703;5849;19492;80725;195.0;2014;True;48;6.89957264957265
90.0;Veres István;1966;M3;HUN;-;Budapest;M;213;F3/51;5142;7192;7192;19526;6043;6096;8722;20861;4894;6607;10192;21693;6043;7845;6359;20247;82327;195.0;2014;True;48;7.036495726495726
91.0;Vakhal György;1955;M4;HUN;Honvéd Rákóczi SE;Szentes;M;255;F4/8;4870;6113;6113;17096;5244;6158;9932;21334;4141;6780;12593;23514;5431;7159;6374;18964;80908;195.0;2014;True;59;6.915213675213676
12.0;Baka Orsolya Ms.;1978;F2;HUN;-;Mór;F;266;N2/8;5589;6220;6220;18029;6192;0;0;6192;4988;6674;10188;21850;6392;7853;6330;20575;66646;195.0;2014;True;36;5.696239316239316
92.0;Geirnaert, Filip;1969;M3;BEL;-;Drongen;M;433;F3/52;5657;6237;6237;18131;6068;6129;8915;21112;4855;6547;9978;21380;6343;8014;6092;20449;81072;195.0;2014;True;45;6.929230769230769
93.0;Kollár Zoltán;1965;M3;HUN;Knorr-Bremse;Budapest;M;55;F3/53;6024;6754;6754;19532;6118;6086;8467;20671;5102;6770;10210;22082;6196;7652;5318;19166;81451;195.0;2014;True;49;6.961623931623931
94.0;Klam Csaba;1970;M3;HUN;-;Soltvadkert;M;29;F3/54;5188;7696;7696;20580;5918;5993;8526;20437;4926;6560;9819;21305;6155;8154;5942;20251;82573;195.0;2014;True;44;7.0575213675213675
95.0;Sutyinszky Tamás;1972;M3;HUN;-;Budapest;M;180;F3/55;5564;6635;6635;18834;6009;6107;8721;20837;4869;6811;10139;21819;6189;7795;6131;20115;81605;195.0;2014;True;42;6.974786324786324
96.0;Farkas László;1967;M3;HUN;Futóbolondok SE;Budapest;M;20;F3/56;5596;6326;6326;18248;6069;6308;9526;21903;4925;6823;10165;21913;6041;7612;6126;19779;81843;195.0;2014;True;47;6.995128205128205
97.0;Szabó Balázs dr.;1970;M3;HUN;-;Budapest;M;106;F3/57;5531;6346;6346;18223;5909;6273;8606;20788;4893;6881;10162;21936;6481;8147;6437;21065;82012;195.0;2014;True;44;7.009572649572649
98.0;Prekopp Péter Dr.;1978;M2;HUN;-;Budapest;M;156;F2/31;5531;6346;6346;18223;5909;6269;8608;20786;4896;6884;10163;21943;6482;8225;6358;21065;82017;195.0;2014;True;36;7.010000000000001
13.0;Stegmaier, Simone;1963;F3;GER;LG Mauerweg Berlin e.V.;Berlin;F;471;N3/5;5430;7617;7617;20664;5853;6281;9463;21597;4784;6392;10008;21184;5855;7295;5849;18999;82444;195.0;2014;True;51;7.046495726495726
14.0;Bálint Éva;1972;F3;HUN;-;Budapest;F;245;N3/6;5214;6781;6781;18776;5975;5973;8365;20313;4857;6580;10804;22241;6262;8291;6501;21054;82384;195.0;2014;True;42;7.041367521367521
99.0;Dávid Zoltán;1967;M3;HUN;Triász;Nyíregyháza;M;215;F3/58;5488;6359;6359;18206;6113;6103;8912;21128;4968;7123;10358;22449;6347;8016;6084;20447;82230;195.0;2014;True;47;7.028205128205128
100.0;Pljesovszki Roland;1990;M1;HUN;Mogyi SE Baja;Szarvas;M;219;F1/3;5209;8182;8182;21573;5679;5869;9078;20626;4433;8577;11531;24541;5643;6674;4600;16917;83657;195.0;2014;True;24;7.15017094017094
101.0;Sólyom Zoltán;1972;M3;HUN;Ikarus BSE;Budapest;M;143;F3/59;5688;6257;6257;18202;5919;6419;8849;21187;4823;6785;9984;21592;6342;8533;6299;21174;82155;195.0;2014;True;42;7.021794871794872
102.0;Márta Csaba dr.;1969;M3;HUN;-;Gödöllő;M;216;F3/60;5658;6237;6237;18132;6068;6129;8897;21094;5126;7131;10508;22765;6344;8016;5984;20344;82335;195.0;2014;True;45;7.037179487179487
103.0;Szigeti Attila;1970;M3;HUN;-;Siófok;M;167;F3/61;5909;7251;7251;20411;6099;6096;8510;20705;5094;6770;10304;22168;6198;7653;6079;19930;83214;195.0;2014;True;44;7.112307692307692
104.0;Csete Balázs;1980;M2;HUN;-;Dunaújváros;M;207;F2/32;5665;6448;6448;18561;6107;6388;8993;21488;5115;7112;10465;22692;6201;7908;6006;20115;82856;195.0;2014;True;34;7.081709401709402
105.0;Andrási Csaba dr.;1972;M3;HUN;-;Nyíregyháza;M;160;F3/62;5014;5977;5977;16968;5369;6070;11856;23295;4840;6400;10161;21401;5771;8130;7082;20983;82647;195.0;2014;True;42;7.063846153846154
106.0;Böle Ferenc;1975;M2;HUN;-;Vecsés;M;149;F2/33;5438;7518;7518;20474;5918;5995;9420;21333;4871;6557;10167;21595;6159;8153;5941;20253;83655;195.0;2014;True;39;7.15
107.0;Keresztes János;1966;M3;HUN;-;Budapest;M;230;F3/63;5633;6897;6897;19427;5931;6255;9170;21356;4769;7378;9917;22064;5969;8251;6204;20424;83271;195.0;2014;True;48;7.117179487179487
108.0;Lajszner Lajos;1966;M3;HUN;Egri triatlon klub;Eger;M;122;F3/64;5770;7062;7062;19894;5968;6455;9426;21849;5078;6903;10280;22261;6210;7989;6095;20294;84298;195.0;2014;True;48;7.204957264957265
109.0;Rudolf József dr.;1970;M3;HUN;-;Budapest;M;110;F3/65;5784;7208;7208;20200;5720;6840;8819;21379;4776;7018;9650;21444;6032;8381;6487;20900;83923;195.0;2014;True;44;7.172905982905983
15.0;Kovács Nóra dr.;1970;F3;HUN;-;Budapest;F;109;N3/7;5778;7260;7260;20298;5923;6121;8717;20761;4854;6951;10488;22293;6248;8323;6327;20898;84250;195.0;2014;True;44;7.200854700854701
110.0;Szerencsés Szabolcs;1973;M3;HUN;Szolnoki Honvéd Sportegyesület;Szolnok;M;277;F3/66;5402;6729;6729;18860;5978;6130;9918;22026;4872;7130;10933;22935;6260;8269;6523;21052;84873;195.0;2014;True;41;7.254102564102564
111.0;Blücher, Tord;1958;M4;SWE;-;Stora;M;476;F3/67;5879;6805;6805;19489;6123;6374;9582;22079;5140;6989;10386;22515;6265;8091;6431;20787;84870;195.0;2014;True;56;7.253846153846154
112.0;Süle Krisztián Péter;1974;M3;HUN;AEGON Futókör;Budapest;M;179;F3/68;5256;7174;7174;19604;5981;6396;10534;22911;4652;6816;10174;21642;6089;8569;6803;21461;85618;195.0;2014;True;40;7.317777777777778
113.0;Kovács Ádám;1973;M3;HUN;-;Budapest;M;123;F3/69;5304;6837;6837;18978;5952;6264;8953;21169;4986;0;0;4986;0;0;0;0;45133;195.0;2014;True;41;3.8575213675213678
114.0;Heitfeldt, Ulrich;1957;M4;GER;-;Hohenhameln;M;403;F4/9;5615;7288;7288;20191;6091;6409;9777;22277;5022;7053;10713;22788;6219;8367;6843;21429;86685;195.0;2014;True;57;7.408974358974359
16.0;Fejér Zsuzsa;1971;F3;HUN;-;Budapest;F;133;N3/8;5612;0;0;5612;6204;6387;8859;21450;5113;6954;10259;22326;6378;9171;7107;22656;72044;195.0;2014;True;43;6.157606837606838
115.0;Wolford Gábor;1982;M2;HUN;-;Szeged;M;210;F2/34;4948;7543;7543;20034;5942;6940;10231;23113;5323;7230;10626;23179;6357;8272;6590;21219;87545;195.0;2014;True;32;7.482478632478632
116.0;Paraniak, Jan;1950;M5;SWE;-;Huddninge;M;480;F4/10;5431;7344;7344;20119;5706;6742;9874;22322;4657;7255;10928;22840;5929;8528;6956;21413;86694;195.0;2014;True;64;7.409743589743591
117.0;Krén Gábor;1969;M3;HUN;-;Bakonynána;M;184;F3/70;6108;6868;6868;19844;6777;7062;9595;23434;5493;0;0;5493;6049;7571;5994;19614;68385;195.0;2014;True;45;5.8448717948717945
118.0;Körmöczy Zoltán;1971;M3;HUN;Dabasi SE;Vecsés;M;248;F3/71;6168;6922;6922;20012;6708;6493;9995;23196;5124;7512;10651;23287;6683;8849;5230;20762;87257;195.0;2014;True;43;7.457863247863248
119.0;Preil József;1978;M2;HUN;-;Székesfehérvár;M;261;F2/35;5573;6903;6903;19379;6178;6509;8429;21116;5063;7703;10825;23591;6649;9634;7149;23432;87518;195.0;2014;True;36;7.48017094017094
120.0;Berka, Kamil;1976;M2;CZE;-;Rudná;M;410;F2/36;5626;8242;8242;22110;5857;5944;10715;22516;4746;6452;11512;22710;5859;8138;8053;22050;89386;195.0;2014;True;38;7.63982905982906
17.0;Csúzdi-Hack Zsanett;1984;F2;HUN;-;Tahitótfalu;F;136;N2/9;5546;7557;7557;20660;6255;6467;10069;22791;4882;7820;10971;23673;6747;8199;6128;21074;88198;195.0;2014;True;30;7.538290598290598
18.0;Csatho Lilla;1991;F1;HUN;DVSI;Dunaújváros;F;176;N1/1;5894;6589;6589;19072;6490;6657;9690;22837;5661;7811;11256;24728;6778;8571;6528;21877;88514;195.0;2014;True;23;7.565299145299146
121.0;Deák, Andreas;1963;M4;GER;LG Mauerweg Berlin e.V.;Berlin;M;474;F3/72;5665;6837;6837;19339;6340;7191;9519;23050;5146;7022;10572;22740;6509;9096;7364;22969;88098;195.0;2014;True;51;7.52974358974359
122.0;Török Tamás;1992;M1;HUN;Pécsi testkultúra Közhasznú Egyesület;Székesfehérvár;M;242;F1/4;4388;8901;8901;22190;5609;6953;10713;23275;4314;7189;11526;23029;6012;8710;7565;22287;90781;195.0;2014;True;22;7.759059829059829
123.0;Árgyelán Krisztián;1976;M2;HUN;Fősör FC;Kétegyháza;M;157;F2/37;5759;7512;7512;20783;6576;6835;9925;23336;5384;7404;11188;23976;6710;8536;6420;21666;89761;195.0;2014;True;38;7.671880341880342
124.0;Varga Ádám;1985;M2;HUN;-;Püspökladány;M;276;F2/38;5245;8295;8295;21835;6096;6483;9759;22338;5163;0;0;5163;6489;8653;7281;22423;71759;195.0;2014;True;29;6.133247863247863
125.0;Vass János;1967;M3;HUN;-;Budapest;M;203;F3/73;5556;7211;7211;19978;6229;6937;10206;23372;5144;7816;11020;23980;0;0;7226;7226;74556;195.0;2014;True;47;6.372307692307692
126.0;Hajduk, Pavol;1973;M3;SVK;-;Dolný Kubín;M;414;F3/74;5512;6261;6261;18034;5891;6684;9955;22530;4976;7970;11004;23950;6961;9705;7851;24517;89031;195.0;2014;True;41;7.6094871794871795
127.0;Bödő Imre;1980;M2;HUN;-;Seregélyes;M;118;F2/39;5528;7117;7117;19762;0;0;10169;10169;5387;7714;11054;24155;6326;9020;7533;22879;76965;195.0;2014;True;34;6.578205128205128
128.0;Wolfger, Franz;1960;M4;AUT;UniCredit SE;Budapest;M;232;F3/75;5622;8603;8603;22828;6627;7647;10014;24288;4879;7159;10480;22518;6205;9605;6508;22318;91952;195.0;2014;True;54;7.859145299145299
19.0;Strosny, Angela;1966;F3;GER;Läuferherz Darmstadt;Modautal;F;416;N3/9;5644;6647;6647;18938;6409;7503;9708;23620;5642;0;0;5642;6704;10255;8014;24973;73173;195.0;2014;True;48;6.254102564102564
129.0;Ajkay Antal;1950;M5;HUN;Sárvár Kinizsi SE;Budapest;M;104;F4/11;6226;7618;7618;21462;7070;7683;10081;24834;5727;7765;11063;24555;6751;8846;6770;22367;93218;195.0;2014;True;64;7.967350427350428
130.0;Zsigri Szabolcs dr.;1976;M2;HUN;DK Team;Budapest;M;111;F2/40;6584;8066;8066;22716;7012;7403;9566;23981;5534;7890;11277;24701;6751;8725;7362;22838;94236;195.0;2014;True;38;8.054358974358975
131.0;Rakó Tamás;1974;M3;HUN;Nike Futóklub Tata;Tata;M;148;F2/41;6144;8145;8145;22434;6694;6972;9377;23043;5433;7583;11861;24877;6742;9164;8476;24382;94736;195.0;2014;True;40;8.097094017094017
20.0;Udd, Monika;1949;F4;SWE;IF Spartacus;Örebro;F;477;N4/1;6552;7738;7738;22028;6731;7036;9819;23586;5490;7484;11441;24415;7049;9773;7539;24361;94390;195.0;2014;True;65;8.067521367521367
21.0;Schneller Erika;1968;F3;HUN;-;Százhalombatta;F;239;N3/10;6202;8361;8361;22924;6708;7406;10244;24358;5481;7918;11527;24926;6691;9365;7389;23445;95653;195.0;2014;True;46;8.175470085470085
22.0;Czira Tamásné;1975;F2;HUN;-;Érd;F;162;N2/10;6202;8266;8266;22734;6714;7400;10245;24359;5475;0;0;5475;6685;9367;7411;23463;76031;195.0;2014;True;39;6.498376068376069
23.0;Császár Noémi;1973;F3;HUN;-;Tahitótfalu (Tahi);F;166;N3/11;6129;7541;7541;21211;7041;7151;9867;24059;6097;7851;12240;26188;7463;9552;7429;24444;95902;195.0;2014;True;41;8.196752136752137
132.0;Iváncsics Zsolt;1968;M3;HUN;EMU;Orosháza;M;285;F3/76;6230;7825;7825;21880;6748;7814;11277;25839;5434;7968;11483;24885;6885;9417;7140;23442;96046;195.0;2014;True;46;8.209059829059829
133.0;Löchner, Günter;1959;M4;GER;L-mobile;Sulzbach;M;438;F3/77;6307;7795;7795;21897;6975;7492;10075;24542;5523;7861;11365;24749;6981;9824;8618;25423;96611;195.0;2014;True;55;8.257350427350428
134.0;Demény Gábor;1980;M2;HUN;-;Szolnok;M;152;F2/42;6581;7999;7999;22579;7019;7440;10549;25008;5850;0;0;5850;7198;9735;7285;24218;77655;195.0;2014;True;34;6.637179487179488
135.0;Belvaracz Sándor;1968;M3;HUN;Kadarka Futóegyesület;Szekszárd;M;257;F3/78;6290;8188;8188;22666;6690;7166;10812;24668;5613;8033;11937;25583;6818;10002;8237;25057;97974;195.0;2014;True;46;8.373846153846154
24.0;Widmann, Monika;1958;F4;GER;L-mobile;Sulzbach;F;439;N3/12;6304;7797;7797;21898;6976;7965;9712;24653;5522;8150;12014;25686;6979;10260;8184;25423;97660;195.0;2014;True;56;8.347008547008548
25.0;Takács Edina;1972;F3;HUN;-;Dévaványa;F;147;N3/13;5811;8106;8106;22023;6844;7847;10008;24699;5673;8022;12173;25868;7413;10920;8004;26337;98927;195.0;2014;True;42;8.455299145299145
999.0;Mester Gábor;1978;M2;HUN;-;Győr;M;154;F2/;5225;0;0;5225;0;0;0;0;0;0;0;0;0;0;0;0;5225;15.0;2014;False;36;5.805555555555555
999.0;Noichl, Gabriele;1959;F4;GER;LG Mauerweg Berlin e.V.;Berlin;F;472;N3/;6053;8297;8297;22647;0;0;0;0;4985;8095;10936;24016;6594;9531;6868;22993;69656;142.0;2014;False;55;8.175586854460095
999.0;Wiesler, Peter;1955;M4;SWE;-;Akersberga;M;479;F4/;0;0;0;0;0;0;0;0;5465;0;0;5465;0;0;0;0;5465;43.0;2014;False;59;2.1182170542635657
999.0;Borsós Krisztián;1973;M3;HUN;-;Budapest;M;177;F3/;5621;8502;8502;22625;0;0;0;0;4672;7236;11884;23792;6017;9482;8804;24303;70720;142.0;2014;False;41;8.300469483568076
999.0;Koffein Kapitány;1979;M2;HUN;-;Szajol;M;129;F2/;6194;7836;7836;21866;6750;8432;0;15182;0;0;0;0;0;0;0;0;37048;79.0;2014;False;35;7.816033755274262
999.0;Martinák Anikó;1973;F3;HUN;-;Budapest;F;258;N3/;4745;6589;6589;17923;5279;5836;9801;20916;0;0;0;0;0;0;0;0;38839;101.0;2014;False;41;6.4090759075907595
999.0;Marion, Gianpietro;1957;M4;ITA;-;Stuttgart;M;429;F4/;5516;8618;8618;22752;6856;7878;11332;26066;0;0;0;0;0;0;0;0;48818;101.0;2014;False;57;8.055775577557755
999.0;Garami Csongor;1968;M3;HUN;-;Törökbálint;M;116;F3/;5250;7843;7843;20936;0;0;0;0;4464;6585;10353;21402;0;0;0;0;42338;91.0;2014;False;46;7.754212454212454
999.0;Hack Román Antal;1974;M3;HUN;Hack-i mer az nyer;Nyergesújfalu;M;25;F2/;5940;9172;9172;24284;0;0;0;0;5273;7733;12058;25064;6883;10340;7874;25097;74445;142.0;2014;False;40;8.737676056338028
999.0;Berzy Judith;1973;F3;HUN;-;Budapest;F;22;N3/;6127;8299;8299;22725;0;0;0;0;0;0;0;0;13355;2726;8539;24620;47345;98.0;2014;False;41;8.05187074829932
999.0;De Vitis, Antonio;1966;M3;ITA;-;Stuttgart;M;431;F3/;5764;7086;7086;19936;6826;6393;9295;22514;5290;7645;11812;24747;0;0;0;0;67197;144.0;2014;False;48;7.777430555555556
999.0;Fejes László;1973;M3;HUN;SUHANJ!;Budapest;M;108;F3/;5535;6457;6457;18449;5740;5900;8336;19976;4739;6501;10090;21330;0;0;0;0;59755;144.0;2014;False;41;6.916087962962963
999.0;Tóth Viktor Ádám;1992;M1;HUN;-;Balatonboglár;M;140;F1/;4075;5167;5167;14409;4441;0;0;4441;3787;5324;7986;17097;5040;8740;0;13780;49727;180.0;2014;False;22;4.604351851851852
999.0;Ladányi Tímea;1986;F2;HUN;Margitszigeti AC;Budapest;F;224;N2/;4615;0;0;4615;0;0;0;0;0;0;0;0;0;0;0;0;4615;15.0;2014;False;28;5.127777777777778
999.0;Maczó András;1949;M5;HUN;Zöldgömb SK;Budapest;M;26;F4/;0;0;0;0;0;0;0;0;5739;0;0;5739;7937;0;0;7937;13676;59.0;2014;False;65;3.863276836158192
999.0;Valkiainen, Veiko;1975;M2;EST;-;Tallinn;M;427;F2/;6222;6795;6795;19812;6882;0;0;6882;0;0;0;0;0;0;0;0;26694;101.0;2014;False;39;4.404950495049505
999.0;Stossberger, Udo Peter;1963;M4;GER;VFL Ostelsheim;Calw Stammheim;M;425;F3/;5574;7235;7235;20044;6000;6438;9477;21915;5037;7728;11142;23907;0;0;0;0;65866;144.0;2014;False;51;7.623379629629629
999.0;Toth Balazs Mr.;1969;M3;HUN;-;Felsőörs;M;103;F3/;0;0;0;0;0;0;0;0;5133;7399;11658;24190;0;0;0;0;24190;43.0;2014;False;45;9.375968992248062
999.0;Zsigri Katalin;1980;F2;HUN;DK Team;Szolnok (Szandaszőlős);F;204;N2/;6548;7634;7634;21816;6635;7286;10255;24176;5723;8422;0;14145;0;0;0;0;60137;131.0;2014;False;34;7.651017811704834
999.0;Nation, Rob;1964;M3;GBR;-;Chichester;M;428;F3/;5770;6919;6919;19608;0;0;0;0;0;0;0;0;15067;7501;0;22568;42176;83.0;2014;False;50;8.469076305220883
999.0;Reineberg, Tarmo;1974;M3;EST;-;Harjumaa;M;426;F2/;6221;6794;6794;19809;6823;0;0;6823;0;0;0;0;0;0;0;0;26632;101.0;2014;False;40;4.3947194719471945
999.0;Juhász Péter;1970;M3;HUN;Spuri SC;Budapest;M;270;F3/;4011;5314;5314;14639;0;0;0;0;0;0;0;0;0;0;0;0;14639;48.0;2014;False;44;5.0829861111111105
999.0;Pospisil, David;1978;M2;CZE;-;Brno;M;405;F2/;5323;7952;7952;21227;0;0;0;0;0;0;0;0;0;0;0;0;21227;48.0;2014;False;36;7.370486111111112
999.0;Brandt Zoltán;1969;M3;HUN;-;Veresegyház;M;259;F3/;5510;0;0;5510;6179;6927;9824;22930;0;0;0;0;0;0;0;0;28440;101.0;2014;False;45;4.693069306930693
999.0;Kádár-Csoboth Péter;1978;M2;HUN;Futóbolondok SE;Budapest;M;286;F2/;5083;5204;5204;15491;5154;5161;0;10315;0;0;0;0;0;0;0;0;25806;79.0;2014;False;36;5.444303797468355
999.0;Paraniak, Barbro;1956;F4;SWE;-;Huddninge;F;478;N4/;0;0;0;0;0;0;0;0;5443;8012;12042;25497;7148;0;0;7148;32645;94.0;2014;False;58;5.788120567375887
999.0;Zömbik László;1961;M4;HUN;Keszthelyi Kilométerek;Keszthely;M;253;F3/;5635;6624;6624;18883;5958;6021;8236;20215;4993;0;0;4993;0;0;0;0;44091;144.0;2014;False;53;5.103125
999.0;Szabó István;1977;M2;HUN;Nike Futóklub - Győr;Győr;M;169;F2/;5216;5662;5662;16540;5601;5791;8220;19612;4849;6851;10258;21958;0;0;0;0;58110;144.0;2014;False;37;6.725694444444445
999.0;Jánosi Kornél dr.;1964;M3;HUN;Buda Fitness;Szentendre;M;120;F3/;5944;8788;8788;23520;0;0;0;0;0;0;0;0;0;0;0;0;23520;48.0;2014;False;50;8.166666666666666
999.0;Endrődi Gábor;1978;M2;HUN;Buda-Cash Békéscsabai AC;Győrújbarát;M;175;F2/;4655;5121;5121;14897;5132;5140;7334;17606;0;0;0;0;0;0;0;0;32503;101.0;2014;False;36;5.363531353135314
999.0;Kecskés László;1964;M3;HUN;-;Budapest;M;130;F3/;5168;7071;7071;19310;0;0;0;0;5063;7201;10431;22695;0;0;0;0;42005;91.0;2014;False;50;7.693223443223443
1.0;Steib Péter;1980;M2;HUN;SZUFLA;Szigetszentmárton;M;261;F2/1;3538;7281;0;10819;3912;7853;0;11765;3201;7178;0;10379;4136;9230;0;13366;46329;195.0;2013;True;33;3.9597435897435895
2.0;Baldauf, Marcus;1976;M2;GER;-;Brotterode;M;211;F2/2;4012;7995;0;12007;4123;8219;0;12342;3377;7745;0;11122;4330;9228;0;13558;49029;195.0;2013;True;37;4.19051282051282
3.0;Kiss Sándor;1965;M3;HUN;Pécsi Futóklub;Soltvadkert;M;297;F3/1;3928;7956;0;11884;4120;8342;0;12462;3382;7797;0;11179;4361;9626;0;13987;49512;195.0;2013;True;48;4.231794871794872
4.0;Herget, Thomas;1967;M3;GER;LG Fulda;Fulda;M;209;F3/2;3928;7971;0;11899;4125;8343;0;12468;3368;7784;0;11152;4465;11027;0;15492;51011;195.0;2013;True;46;4.35991452991453
5.0;Juhász Péter;1970;M3;HUN;Spuri SC;Budapest;M;304;F3/3;3927;7954;0;11881;4118;8342;0;12460;3394;7814;0;11208;4633;10358;0;14991;50540;195.0;2013;True;43;4.319658119658119
6.0;Vakhal Norbert;1979;M2;HUN;Honvéd Szondi SE;Székesfehérvár;M;276;F2/3;4064;8225;0;12289;4197;8640;0;12837;3491;8090;0;11581;4635;10359;0;14994;51701;195.0;2013;True;34;4.418888888888889
7.0;Balogh Róbert;1980;M2;HUN;-;Békéscsaba;M;313;F2/4;5054;9860;0;14914;4897;9793;0;14690;3876;8983;0;12859;5233;11498;0;16731;59194;195.0;2013;True;33;5.05931623931624
8.0;Szőnyi Ferenc;1964;M3;HUN;KEFE- Komárom;Komárom;M;163;F3/4;4334;8989;0;13323;4639;9564;0;14203;0;9016;0;9016;4869;11046;0;15915;52457;195.0;2013;True;49;4.483504273504273
9.0;Vaczkó Zsolt;1971;M3;HUN;-;Budapest;M;248;F3/5;4751;9550;0;14301;4698;9457;0;14155;3922;9017;0;12939;4912;11020;0;15932;57327;195.0;2013;True;42;4.89974358974359
10.0;Tigyi László;1960;M4;HUN;Nudlik SE;Budapest;M;246;F3/6;4650;9257;0;13907;0;0;0;0;3947;9214;0;13161;5050;10975;0;16025;43093;195.0;2013;True;53;3.683162393162393
11.0;Havasi György;1973;M3;HUN;Hírös Pockok HSE;Kecskemét;M;259;F2/5;4514;9281;0;13795;4862;9842;0;14704;3897;8976;0;12873;5060;11023;0;16083;57455;195.0;2013;True;40;4.910683760683761
12.0;Dudás Zsolt;1968;M3;HUN;-;Soltvadkert;M;227;F3/7;4511;9309;0;13820;4882;10094;0;14976;3908;9427;0;13335;5236;11622;0;16858;58989;195.0;2013;True;45;5.041794871794871
13.0;Papp Sándor;1970;M3;HUN;Debreceni Rendőr SE;Vámospércs;M;144;F3/8;4412;9024;0;13436;4895;10117;0;15012;3976;9186;0;13162;4926;10671;0;15597;57207;195.0;2013;True;43;4.88948717948718
1.0;Gyebnár Éva;1979;F2;HUN;Békési DAC;Békéscsaba;F;162;N2/1;5031;10139;0;15170;5170;10129;0;15299;4264;9838;0;14102;5255;11539;0;16794;61365;195.0;2013;True;34;5.244871794871795
14.0;Simon Zoltán;1970;M3;HUN;-;Solymár;M;37;F3/9;4858;9767;0;14625;5160;10203;0;15363;4361;9801;0;14162;5421;11659;0;17080;61230;195.0;2013;True;43;5.233333333333333
15.0;Kádár-Csoboth Péter;1978;M2;HUN;Futóbolondok SE;Budapest;M;280;F2/6;5198;10364;0;15562;5150;10266;0;15416;4215;9647;0;13862;5123;11249;0;16372;61212;195.0;2013;True;35;5.231794871794872
2.0;Schliep, Martina;1969;F3;GER;LG Mauerweg Berlin;Berlin;F;196;N3/1;5012;10084;0;15096;5147;10109;0;15256;4268;9843;0;14111;5257;11624;0;16881;61344;195.0;2013;True;44;5.243076923076923
16.0;Veress Béla;1977;M2;HUN;-;Budapest;M;149;F2/7;4434;9156;0;13590;4862;9995;0;14857;4109;9629;0;13738;5364;11502;0;16866;59051;195.0;2013;True;36;5.047094017094016
17.0;Endrődi Gábor;1978;M2;HUN;-;Békéscsaba;M;235;F2/8;5033;10140;0;15173;5129;10088;0;15217;4224;9793;0;14017;5255;11693;0;16948;61355;195.0;2013;True;35;5.244017094017094
3.0;Rácz Adél;1968;F3;HUN;Veszprémi Triatlon Egyesület;Budapest;F;223;N3/2;4588;9684;0;14272;5118;10133;0;15251;4196;9772;0;13968;5259;11691;0;16950;60441;195.0;2013;True;45;5.165897435897436
4.0;Máténé Varju Edit;1971;F3;HUN;UNIX-IRONTEAM SE;Székesfehérvár;F;283;N3/3;5033;10141;0;15174;5141;10104;0;15245;4262;9842;0;14104;5259;11692;0;16951;61474;195.0;2013;True;42;5.254188034188034
18.0;Lukács Albert (Blue);1974;M2;HUN;SKSE;Budaörs;M;247;F2/9;4390;9031;0;13421;5183;10513;0;15696;4238;9507;0;13745;5530;12250;0;17780;60642;195.0;2013;True;39;5.183076923076923
19.0;Mészáros Zoltán;1964;M3;HUN;Spuri SC;Budapest;M;284;F3/10;4963;10079;0;15042;5182;10170;0;15352;4335;9802;0;14137;5228;11648;0;16876;61407;195.0;2013;True;49;5.248461538461538
20.0;Vakhal György;1955;M4;HUN;Honvéd Rákóczi SE;Szentes;M;279;F4/1;4518;9488;0;14006;4768;10004;0;14772;4086;9696;0;13782;5041;11390;0;16431;58991;195.0;2013;True;58;5.041965811965811
21.0;Ossó Zoltán;1976;M2;HUN;ELTE Polythlon;Budapest;M;311;F2/10;4272;9005;0;13277;4669;9613;0;14282;3902;9290;0;13192;5160;12201;0;17361;58112;195.0;2013;True;37;4.966837606837607
22.0;Kollár Szabolcs;1970;M3;HUN;Záróbusz Felvezetők ESK;Budapest;M;250;F3/11;4571;9458;0;14029;4844;10086;0;14930;4255;9706;0;13961;5716;12010;0;17726;60646;195.0;2013;True;43;5.183418803418803
23.0;Károlyi János;1963;M3;HUN;-;Mezőberény;M;141;F3/12;5032;10143;0;15175;5121;10088;0;15209;4024;9329;0;13353;5343;0;0;5343;49080;195.0;2013;True;50;4.194871794871795
24.0;Bódis Tamás;1988;M1;HUN;Szolnoki Honvéd Sportegyesület;Hangony;M;301;F1/1;5083;10458;0;15541;5202;10634;0;15836;4368;10258;0;14626;5302;0;0;5302;51305;195.0;2013;True;25;4.3850427350427355
25.0;Szabó Béla;1963;M3;HUN;-;Gyenesdiás;M;139;F3/13;4668;9628;0;14296;5096;10239;0;15335;4199;9752;0;13951;5686;12652;0;18338;61920;195.0;2013;True;50;5.292307692307692
26.0;Salamon István;1962;M4;HUN;-;Mezőtárkány;M;34;F3/14;4856;9992;0;14848;5149;10365;0;15514;4192;9735;0;13927;5473;12094;0;17567;61856;195.0;2013;True;51;5.286837606837607
27.0;Geréd László;1970;M3;HUN;-;Balatonalmádi;M;303;F3/15;5397;10776;0;16173;5489;10834;0;16323;4277;9593;0;13870;5550;11780;0;17330;63696;195.0;2013;True;43;5.444102564102564
28.0;Hergovics Gábor;1965;M3;HUN;Szondi SE;Székesfehérvár;M;286;F3/16;4590;9684;0;14274;4907;9844;0;14751;4272;10001;0;14273;5530;12453;0;17983;61281;195.0;2013;True;48;5.237692307692308
29.0;Csépe György ifj.;1971;M3;HUN;-;Gyöngyös;M;262;F3/17;4754;9872;0;14626;5089;10436;0;15525;4013;9707;0;13720;5112;11505;0;16617;60488;195.0;2013;True;42;5.1699145299145295
30.0;Darányi János;1963;M3;HUN;-;Soltvadkert;M;226;F3/18;4974;10212;0;15186;5286;10720;0;16006;4192;9735;0;13927;5261;11704;0;16965;62084;195.0;2013;True;50;5.306324786324787
31.0;Dobi Zsigmond;1974;M2;HUN;KEFE- Komárom;Komárom;M;263;F2/11;4566;9470;0;14036;4907;10015;0;14922;4159;9749;0;13908;5246;12034;0;17280;60146;195.0;2013;True;39;5.1406837606837605
32.0;Soós Elek;1970;M3;HUN;Dunafüredi Vizisport;Százhalombatta;M;234;F3/19;4954;0;0;4954;5133;10295;0;15428;4247;9780;0;14027;5280;12319;0;17599;52008;195.0;2013;True;43;4.445128205128205
33.0;Keresztesi László;1965;M3;HUN;Jászberényi Triatlon;Ásványráró;M;254;F3/20;4631;9176;0;13807;4738;9662;0;14400;3974;9928;0;13902;5527;12923;0;18450;60559;195.0;2013;True;48;5.175982905982906
34.0;Szerencsés Szabolcs;1973;M3;HUN;Szolnoki Honvéd Sportegyesület;Szolnok;M;302;F2/12;5084;10475;0;15559;5294;10763;0;16057;4361;10255;0;14616;5309;11709;0;17018;63250;195.0;2013;True;40;5.405982905982906
35.0;Nagy Imre;1981;M2;HUN;-;Egyek;M;296;F2/13;4570;10066;0;14636;5433;11086;0;16519;4389;10098;0;14487;5524;11698;0;17222;62864;195.0;2013;True;32;5.372991452991453
36.0;Vadász Attila;1964;M3;HUN;Tapolca Honvéd SE;Szigliget;M;266;F3/21;4510;9238;0;13748;5292;10895;0;16187;4133;9630;0;13763;5402;12292;0;17694;61392;195.0;2013;True;49;5.247179487179487
5.0;Martinák Anikó;1973;F3;HUN;-;Budapest;F;298;N2/2;4801;9930;0;14731;5093;10448;0;15541;4228;9972;0;14200;5348;12067;0;17415;61887;195.0;2013;True;40;5.28948717948718
6.0;Gyűrűs Nóra;1979;F2;HUN;Honvéd Szondi SE;Székesfehérvár;F;275;N2/3;4994;10132;0;15126;4990;10359;0;15349;4298;10264;0;14562;5448;12178;0;17626;62663;195.0;2013;True;34;5.3558119658119665
7.0;Druskó Zsófia;1966;F3;HUN;Kanizsai Futóklub;Törökbálint;F;252;N3/4;4855;9996;0;14851;5136;10362;0;15498;4304;10008;0;14312;5841;12874;0;18715;63376;195.0;2013;True;47;5.4167521367521365
37.0;Kovalik Zoltán;1975;M2;HUN;Taszári Honvéd SE;Taszár;M;299;F2/14;5535;11749;0;17284;5506;10886;0;16392;4054;9304;0;13358;5518;11917;0;17435;64469;195.0;2013;True;38;5.510170940170941
38.0;Pók János;1963;M3;HUN;Axiál Kft.;Gárdony (Agárd);M;33;F3/22;4663;9343;0;14006;5397;11188;0;16585;4281;0;0;4281;5577;12452;0;18029;52901;195.0;2013;True;50;4.521452991452991
39.0;Domán Gábor;1960;M4;HUN;Tapolca Honvéd SE;Tapolca;M;258;F3/23;4372;9276;0;13648;4817;10288;0;15105;4160;10478;0;14638;5318;12338;0;17656;61047;195.0;2013;True;53;5.217692307692308
40.0;Kerekes László;1967;M3;HUN;-;Jászberény;M;151;F3/24;4628;9445;0;14073;5224;10511;0;15735;4591;10955;0;15546;5727;13086;0;18813;64167;195.0;2013;True;46;5.484358974358974
41.0;Pintér Sándor;1975;M2;HUN;Pénzügyőr SE;Gödöllő;M;310;F2/15;4412;9333;0;13745;4990;10347;0;15337;4274;10785;0;15059;5065;11637;0;16702;60843;195.0;2013;True;38;5.20025641025641
42.0;Kertész Ervin;1970;M3;HUN;Nike Futóklub - Győr;Gyöngyös;M;147;F3/25;4771;9987;0;14758;5747;11682;0;17429;4016;9312;0;13328;5659;12204;0;17863;63378;195.0;2013;True;43;5.4169230769230765
43.0;Márkus István;1972;M3;HUN;Kadarka Futóegyesület;Szekszárd;M;236;F3/26;5250;10772;0;16022;5498;0;0;5498;4437;0;0;4437;5393;11696;0;17089;43046;195.0;2013;True;41;3.679145299145299
44.0;Lukovics Béla;1953;M5;HUN;Békéscsabai AC;Békéscsaba;M;58;F4/2;5420;10875;0;16295;5586;11153;0;16739;4546;0;0;4546;5660;12203;0;17863;55443;195.0;2013;True;60;4.738717948717948
45.0;Czaltig Zsolt;1974;M2;HUN;-;Százhalombatta;M;136;F2/16;5279;0;0;5279;5337;10990;0;16327;4437;0;0;4437;5413;12084;0;17497;43540;195.0;2013;True;39;3.721367521367521
46.0;Kreidl Csaba;1974;M2;HUN;-;Tatabánya;M;265;F2/17;5283;10773;0;16056;5408;10914;0;16322;4462;10527;0;14989;5472;12038;0;17510;64877;195.0;2013;True;39;5.545042735042735
47.0;Csécsei Zoltán;1984;M2;HUN;-;Marcali;M;153;F2/18;0;0;0;0;5126;10140;0;15266;4262;9907;0;14169;6803;14701;0;21504;50939;195.0;2013;True;29;4.353760683760684
48.0;Huszty Béla;1964;M3;HUN;KELE;Kalocsa;M;282;F3/27;5363;10904;0;16267;5629;0;0;5629;4507;10540;0;15047;5393;11849;0;17242;54185;195.0;2013;True;49;4.631196581196582
49.0;Sebestyén Róbert;1968;M3;HUN;-;Szolnok;M;166;F3/28;5016;10425;0;15441;5305;10837;0;16142;4457;10679;0;15136;5565;12332;0;17897;64616;195.0;2013;True;45;5.522735042735043
50.0;Láng István;1957;M4;HUN;Messer Futóklub;Göd (Alsógöd);M;30;F3/29;5041;10234;0;15275;5656;11347;0;17003;4509;10118;0;14627;5960;13273;0;19233;66138;195.0;2013;True;56;5.6528205128205125
8.0;Kubovics Éva;1969;F3;HUN;NIKE Nyíregyháza;Nyíregyháza;F;256;N3/5;5800;11405;0;17205;5225;10997;0;16222;4224;10236;0;14460;5771;13098;0;18869;66756;195.0;2013;True;44;5.705641025641025
9.0;Tomán Edina;1981;F2;HUN;-;Budapest;F;309;N2/4;5050;10439;0;15489;5560;11110;0;16670;4599;10795;0;15394;5885;12887;0;18772;66325;195.0;2013;True;32;5.668803418803419
51.0;Vogl Péter;1966;M3;HUN;-;Tordas;M;285;F3/30;0;10389;0;10389;5830;11951;0;17781;4573;10428;0;15001;5777;12702;0;18479;61650;195.0;2013;True;47;5.269230769230769
52.0;Kiss Péter;1986;M1;HUN;Margita 344,2 TSE;Görcsöny;M;17;F2/19;4418;9297;0;13715;5094;10841;0;15935;4445;10638;0;15083;5749;13170;0;18919;63652;195.0;2013;True;27;5.4403418803418795
53.0;Farkas László;1967;M3;HUN;Futóbolondok SE;Budapest;M;20;F3/31;5041;10233;0;15274;5657;11369;0;17026;4499;10407;0;14906;5959;13278;0;19237;66443;195.0;2013;True;46;5.678888888888889
54.0;Kecskés László;1964;M3;HUN;-;Budapest;M;107;F3/32;5231;10784;0;16015;5606;11269;0;16875;4425;10362;0;14787;6002;12965;0;18967;66644;195.0;2013;True;49;5.696068376068376
55.0;Lindgren, Bengt;1947;M5;SWE;Vallentuna IK;Stockholm;M;193;F4/3;5242;10715;0;15957;5376;11094;0;16470;4446;10346;0;14792;5729;12822;0;18551;65770;195.0;2013;True;66;5.621367521367522
56.0;Takács Krisztián (Csipi);1974;M2;HUN;-;Budapest;M;237;F2/20;5255;10647;0;15902;5534;11037;0;16571;4595;10722;0;15317;5765;12870;0;18635;66425;195.0;2013;True;39;5.677350427350427
57.0;Séra István;1960;M4;HUN;-;Budapest;M;36;F3/33;5158;11017;0;16175;5566;11505;0;17071;4406;10211;0;14617;5818;12871;0;18689;66552;195.0;2013;True;53;5.688205128205128
58.0;Grabarics János;1981;M2;HUN;-;Budapest;M;157;F2/21;5178;10423;0;15601;5238;10833;0;16071;4225;10145;0;14370;7079;14192;0;21271;67313;195.0;2013;True;32;5.753247863247863
59.0;Kárász Zakariás;1978;M2;HUN;-;Budapest;M;307;F2/22;4671;9931;0;14602;5421;11185;0;16606;4453;0;0;4453;6232;13868;0;20100;55761;195.0;2013;True;35;4.765897435897436
10.0;Szentpéteri Gabriella dr.;1972;F3;HUN;Nike Futóklub, Nyíregyháza;Nyíregyháza;F;143;N3/6;5804;0;0;5804;5684;11509;0;17193;4575;0;0;4575;5767;12969;0;18736;46308;195.0;2013;True;41;3.957948717948718
60.0;Antal Péter;1968;M3;HUN;-;Budapest;M;170;F3/34;5645;11417;0;17062;5825;11630;0;17455;4684;10781;0;15465;5852;12720;0;18572;68554;195.0;2013;True;45;5.859316239316239
61.0;Komjáti Sándor dr.;1964;M3;HUN;Tapolca Honvéd SE;Tapolca;M;300;F3/35;5019;10331;0;15350;5287;10918;0;16205;4513;10872;0;15385;5803;12704;0;18507;65447;195.0;2013;True;49;5.593760683760683
11.0;Vida Beáta;1979;F2;HUN;-;Tatabánya;F;257;N2/5;5791;11674;0;17465;5822;11648;0;17470;4689;10779;0;15468;5851;12780;0;18631;69034;195.0;2013;True;34;5.90034188034188
62.0;Pálfi János;1977;M2;HUN;-;Tatabánya;M;146;F2/23;4676;10024;0;14700;5270;11142;0;16412;4158;10344;0;14502;5532;13211;0;18743;64357;195.0;2013;True;36;5.50059829059829
63.0;Szőke Tamás;1970;M3;HUN;Szondi SE;Székesfehérvár;M;14;F3/36;5794;11674;0;17468;5820;11647;0;17467;4692;10787;0;15479;5853;12780;0;18633;69047;195.0;2013;True;43;5.901452991452992
12.0;Christ, Heike;1969;F3;GER;LT Sulz am Eck;Horb-Mühringen;F;191;N3/7;5609;11380;0;16989;5770;11616;0;17386;4857;11094;0;15951;5866;12869;0;18735;69061;195.0;2013;True;44;5.9026495726495725
13.0;Nixon, Rosemary;1968;F3;GBR;-;Annecy;F;207;N3/8;4977;10398;0;15375;5278;11168;0;16446;4516;10927;0;15443;6052;0;0;6052;53316;195.0;2013;True;45;4.556923076923077
64.0;Vincent, Jonas;1970;M3;SWE;IFK SALA;Sala;M;204;F3/37;5240;10658;0;15898;5700;11681;0;17381;4775;11186;0;15961;6424;14032;0;20456;69696;195.0;2013;True;43;5.9569230769230765
65.0;Gáspár Viktor;1973;M3;HUN;ALLTECH;Budapest;M;269;F2/24;5638;11355;0;16993;5881;11934;0;17815;4574;10645;0;15219;6302;13592;0;19894;69921;195.0;2013;True;40;5.976153846153846
66.0;Malatyinszki Szilárd dr.;1978;M2;HUN;-;Békéscsaba;M;132;F2/25;5875;11790;0;17665;5898;11890;0;17788;4800;11041;0;15841;6229;13357;0;19586;70880;195.0;2013;True;35;6.058119658119658
14.0;Csákány Krisztina;1971;F3;HUN;Futóbarátok;Győrújbarát;F;271;N3/9;5563;11481;0;17044;5893;11866;0;17759;4983;11340;0;16323;6161;13355;0;19516;70642;195.0;2013;True;42;6.0377777777777775
67.0;Hogya Dénes;1981;M2;HUN;-;Miskolc (Szirma);M;171;F2/26;5171;10901;0;16072;6190;12439;0;18629;4676;10757;0;15433;5848;13547;0;19395;69529;195.0;2013;True;32;5.9426495726495725
15.0;Zuba Magdolna;1965;F3;HUN;-;Mezőberény;F;142;N3/10;5400;11402;0;16802;5841;11633;0;17474;4628;11322;0;15950;6027;14048;0;20075;70301;195.0;2013;True;48;6.008632478632479
68.0;Bakó Gábor;1968;M3;HUN;-;Budakalász;M;134;F3/38;4665;10155;0;14820;4922;11016;0;15938;3904;11414;0;15318;6214;14494;0;20708;66784;195.0;2013;True;45;5.708034188034188
69.0;Bíró Géza;1967;M3;HUN;-;Balatonkeresztúr;M;281;F3/39;5522;11250;0;16772;5706;11588;0;17294;4880;11658;0;16538;6400;14068;0;20468;71072;195.0;2013;True;46;6.074529914529914
70.0;Blücher, Tord;1958;M4;SWE;-;Storaring;M;205;F3/40;5348;11088;0;16436;5863;12088;0;17951;4879;11318;0;16197;6366;13831;0;20197;70781;195.0;2013;True;55;6.04965811965812
71.0;Sólyom Zoltán;1972;M3;HUN;Ikarus BSE;Budapest;M;164;F3/41;5317;10972;0;16289;5699;11935;0;17634;4799;0;0;4799;6592;14472;0;21064;59786;195.0;2013;True;41;5.10991452991453
72.0;Szabó Zoltán dr.;1958;M4;HUN;-;Dunaújváros;M;244;F3/42;4761;10271;0;15032;5677;11766;0;17443;4826;11616;0;16442;6472;14671;0;21143;70060;195.0;2013;True;55;5.988034188034188
16.0;Pánczél Andrea;1974;F2;HUN;Ironteam SE;Őrbottyán;F;230;N2/6;5547;11362;0;16909;6306;12870;0;19176;5577;12460;0;18037;6181;13363;0;19544;73666;195.0;2013;True;39;6.296239316239316
73.0;Vass János;1967;M3;HUN;-;Budapest;M;131;F3/43;5373;10985;0;16358;5849;0;0;5849;4877;0;0;4877;6253;14042;0;20295;47379;195.0;2013;True;46;4.049487179487179
74.0;Dovala, Adrian;1975;M2;SVK;Drnava;Drnava;M;208;F2/27;5245;10735;0;15980;5898;11973;0;17871;4955;11826;0;16781;6263;14184;0;20447;71079;195.0;2013;True;38;6.075128205128205
75.0;Gáti Levente;1959;M4;HUN;ALLTECH;Budapest;M;270;F3/44;5644;11351;0;16995;5872;12252;0;18124;4555;10644;0;15199;6760;15296;0;22056;72374;195.0;2013;True;54;6.185811965811966
17.0;Leskovics Andrea;1968;F3;HUN;LESI SE;Budapest;F;260;N3/11;5412;11401;0;16813;5858;12047;0;17905;5121;12008;0;17129;6504;14455;0;20959;72806;195.0;2013;True;45;6.222735042735043
76.0;Klam Csaba;1970;M3;HUN;-;Szajol;M;29;F3/45;5286;11318;0;16604;5719;11622;0;17341;5043;11800;0;16843;6267;14020;0;20287;71075;195.0;2013;True;43;6.0747863247863245
18.0;Békésiné Janik Szilvia;1977;F2;HUN;-;Budapest;F;228;N2/7;5065;10676;0;15741;5600;12261;0;17861;4804;11332;0;16136;5984;14332;0;20316;70054;195.0;2013;True;36;5.987521367521367
77.0;Szalay Krisztián;1973;M3;HUN;Zugflow;Budapest;M;314;F2/28;5246;10886;0;16132;5879;12177;0;18056;4826;12193;0;17019;6295;14415;0;20710;71917;195.0;2013;True;40;6.146752136752136
78.0;Gaeckle, Andreas;1966;M3;GER;-;Kornwestheim;M;190;F3/46;5609;11382;0;16991;5737;11644;0;17381;4866;11510;0;16376;6065;14377;0;20442;71190;195.0;2013;True;47;6.084615384615384
79.0;Tóth László;1978;M2;HUN;-;Budapest;M;111;F2/29;5422;11027;0;16449;5594;11465;0;17059;4865;12622;0;17487;6361;14800;0;21161;72156;195.0;2013;True;35;6.167179487179487
80.0;Schultz György;1974;M2;HUN;Alföld TE;Mezőberény;M;229;F2/30;5425;11049;0;16474;5656;11538;0;17194;5021;12021;0;17042;6647;15207;0;21854;72564;195.0;2013;True;39;6.202051282051283
19.0;Reiman Katalin;1960;F3;HUN;-;Budapest;F;233;N3/12;5085;10936;0;16021;5753;12024;0;17777;4715;11238;0;15953;6219;15103;0;21322;71073;195.0;2013;True;53;6.0746153846153845
20.0;Horváth Mónika;1966;F3;HUN;Mogyi SE Baja;Baja;F;241;N3/13;5730;11742;0;17472;6076;12832;0;18908;5401;12674;0;18075;6640;14823;0;21463;75918;195.0;2013;True;47;6.488717948717948
81.0;Heitfeldt, Ulrich;1957;M4;GER;-;Hohenhameln;M;197;F3/47;5405;0;0;5405;5958;12037;0;17995;5036;0;0;5036;6306;14127;0;20433;48869;195.0;2013;True;56;4.176837606837607
82.0;Beyer, Roland;1948;M5;GER;Sport Ruscher Team;München;M;202;F4/4;5958;12328;0;18286;0;0;0;0;5256;12183;0;17439;6067;13600;0;19667;55392;195.0;2013;True;65;4.734358974358974
83.0;Rudolf József dr.;1970;M3;HUN;-;Budapest;M;114;F3/48;5750;12477;0;18227;5837;12317;0;18154;4966;12052;0;17018;6255;14259;0;20514;73913;195.0;2013;True;43;6.317350427350428
84.0;Zlinszky András;1983;M2;HUN;Regnum Marianum SE;Wien;M;130;F2/31;5252;11075;0;16327;6457;13722;0;20179;4447;10857;0;15304;6166;14132;0;20298;72108;195.0;2013;True;30;6.163076923076923
85.0;Marosi Péter;1975;M2;HUN;IKEA FC;Baja;M;110;F2/32;5799;11850;0;17649;6094;12534;0;18628;5085;12144;0;17229;6129;0;0;6129;59635;195.0;2013;True;38;5.097008547008547
86.0;Paraniak, Jan;1950;M5;SWE;-;Huddinge;M;203;F4/5;5203;11237;0;16440;5777;12619;0;18396;4733;0;0;4733;5838;13539;0;19377;58946;195.0;2013;True;63;5.0381196581196575
87.0;Jelander, Anders;1964;M3;SWE;Simlngsdalens if;Halmstad;M;198;F3/49;5027;10792;0;15819;5791;12034;0;17825;5149;11758;0;16907;6701;15331;0;22032;72583;195.0;2013;True;49;6.203675213675214
88.0;Balogh Ádám;1979;M2;HUN;BKV Előre SC;Budapest;M;221;F2/33;5149;10353;0;15502;5298;14080;0;19378;4431;11274;0;15705;6636;14438;0;21074;71659;195.0;2013;True;34;6.124700854700855
89.0;Ivancso, Béla dr.;1980;M2;SVK;-;Nyíregyháza;M;104;F2/34;5874;12067;0;17941;6167;12483;0;18650;4994;0;0;4994;6897;15346;0;22243;63828;195.0;2013;True;33;5.455384615384615
90.0;Meinhold, Günter;1950;M5;GER;stolpertrupp ihmert;Hemer;M;183;F4/6;6113;12517;0;18630;6160;12536;0;18696;5154;12123;0;17277;6507;14624;0;21131;75734;195.0;2013;True;63;6.472991452991453
91.0;Visy Ferenc;1947;M5;HUN;-;Nagykovácsi;M;222;F4/7;5240;11282;0;16522;5528;12155;0;17683;4569;11133;0;15702;5976;0;0;5976;55883;195.0;2013;True;66;4.776324786324786
92.0;Kreszta Zoltán;1970;M3;HUN;UTE;Budapest;M;11;F3/50;5325;10752;0;16077;5608;11926;0;17534;4781;12358;0;17139;6584;14471;0;21055;71805;195.0;2013;True;43;6.137179487179488
93.0;Tóth Iván Csaba;1974;M2;HUN;Vasemberek Klubja;Fót;M;267;F2/35;5543;11318;0;16861;6004;12592;0;18596;5257;12426;0;17683;7038;15295;0;22333;75473;195.0;2013;True;39;6.450683760683761
21.0;Joó Barbara;1977;F2;HUN;-;Szombathely;F;264;N2/8;5783;11781;0;17564;5967;12628;0;18595;4977;12065;0;17042;6567;14659;0;21226;74427;195.0;2013;True;36;6.361282051282052
94.0;Sutyinszky Tamás;1972;M3;HUN;-;Budapest;M;115;F3/51;5480;11335;0;16815;6059;12619;0;18678;5125;12298;0;17423;6587;0;0;6587;59503;195.0;2013;True;41;5.085726495726496
95.0;Lembke, Peter;1971;M3;SWE;-;Sollentuna;M;195;F3/52;5723;12456;0;18179;6280;13050;0;19330;5359;12213;0;17572;6817;15441;0;22258;77339;195.0;2013;True;42;6.61017094017094
96.0;Nagy Zsolt;1980;M2;HUN;-;Budapest;M;152;F2/36;5037;10646;0;15683;5816;12440;0;18256;5105;12807;0;17912;6757;14847;0;21604;73455;195.0;2013;True;33;6.278205128205128
97.0;Von Uleniecki, Alexander;1968;M3;GER;-;Berlin;M;184;F3/53;6151;12631;0;18782;5845;12105;0;17950;5550;12824;0;18374;6833;15426;0;22259;77365;195.0;2013;True;45;6.612393162393163
98.0;Lajszner Lajos;1966;M3;HUN;Egri triatlon klub;Eger;M;137;F3/54;5795;11960;0;17755;6262;12884;0;19146;5242;12228;0;17470;6706;14808;0;21514;75885;195.0;2013;True;47;6.485897435897436
99.0;Kollár Zoltán;1965;M3;HUN;Knorr-Bremse;Budapest;M;55;F3/55;6332;13125;0;19457;6822;13749;0;20571;5479;12459;0;17938;6598;14244;0;20842;78808;195.0;2013;True;48;6.735726495726496
100.0;Járosi Tamás;1973;M3;HUN;Zebra Futóklub;Budapest;M;118;F2/37;5225;11011;0;16236;5653;12270;0;17923;4968;12555;0;17523;6937;16148;0;23085;74767;195.0;2013;True;40;6.39034188034188
101.0;Rakonczai Gábor;1981;M2;HUN;-;Budapest;M;305;F2/38;5773;11953;0;17726;6078;12449;0;18527;4928;11909;0;16837;7041;16093;0;23134;76224;195.0;2013;True;32;6.514871794871795
102.0;Laborie, Fabrice;1972;M3;FRA;Dubai Creek Striders;Bras;M;200;F3/56;4668;9769;0;14437;5625;12118;0;17743;4821;0;0;4821;6544;14906;0;21450;58451;195.0;2013;True;41;4.995811965811965
103.0;Szalontai Zoltán;1979;M2;HUN;-;Tatabánya;M;117;F2/39;6545;13178;0;19723;6816;13647;0;20463;5369;12263;0;17632;6626;14614;0;21240;79058;195.0;2013;True;34;6.757094017094017
104.0;Blaskó Mihály;1980;M2;HUN;-;Budapest;M;168;F2/40;5488;0;0;5488;6175;12988;0;19163;5244;12655;0;17899;7111;15785;0;22896;65446;195.0;2013;True;33;5.593675213675214
105.0;Deák, Andreas;1963;M3;GER;LG Mauerweg Berlin;Berlin;M;288;F3/57;5648;11741;0;17389;6547;13165;0;19712;5252;12209;0;17461;6842;15426;0;22268;76830;195.0;2013;True;50;6.566666666666666
106.0;Kurpé László dr.;1970;M3;HUN;Triton Triatlon Club Hatvan;Hatvan;M;242;F3/58;6492;13387;0;19879;6791;0;0;6791;5433;0;0;5433;6401;14345;0;20746;52849;195.0;2013;True;43;4.5170085470085475
107.0;Szatmári Gergely;1982;M2;HUN;-;Budapest;M;306;F2/41;5340;11282;0;16622;6261;13087;0;19348;5440;12905;0;18345;6635;14800;0;21435;75750;195.0;2013;True;31;6.4743589743589745
108.0;Neumann, KLaus;1952;M5;GER;0 Marathon Club;Stuttgart;M;206;F4/8;6147;12614;0;18761;6575;13276;0;19851;5533;12810;0;18343;6844;15279;0;22123;79078;195.0;2013;True;61;6.758803418803419
22.0;Sebestyén Linda;1980;F2;HUN;-;Budapest;F;106;N2/9;6021;12594;0;18615;6589;13703;0;20292;4997;12679;0;17676;6714;15082;0;21796;78379;195.0;2013;True;33;6.699059829059829
109.0;Michal, Turek;1982;M2;CZE;-;Prague;M;185;F2/42;6282;12882;0;19164;6711;13634;0;20345;5434;12946;0;18380;6912;15701;0;22613;80502;195.0;2013;True;31;6.880512820512821
110.0;Prekopp Péter dr.;1978;M2;HUN;-;Budapest;M;133;F2/43;5672;11421;0;17093;6279;12978;0;19257;5522;13069;0;18591;7428;16913;0;24341;79282;195.0;2013;True;35;6.776239316239316
111.0;Zaschka, Harald;1969;M3;AUT;-;Traiskirchen;M;210;F3/59;4965;10577;0;15542;6185;13116;0;19301;5449;13159;0;18608;7148;16597;0;23745;77196;195.0;2013;True;44;6.597948717948717
23.0;Czira Tamásné;1975;F2;HUN;-;Érd;F;140;N2/10;6268;12895;0;19163;6557;13647;0;20204;5600;0;0;5600;6896;15664;0;22560;67527;195.0;2013;True;38;5.771538461538462
112.0;Jánosi Kornél dr.;1964;M3;HUN;Buda Fitness;Szentendre;M;121;F3/60;6649;13467;0;20116;6512;13481;0;19993;5545;12871;0;18416;6933;15594;0;22527;81052;195.0;2013;True;49;6.927521367521367
113.0;Fazekas János;1968;M3;HUN;Vasemberek Klubja;Budapest;M;138;F3/61;6651;13467;0;20118;6511;13480;0;19991;5544;12870;0;18414;6933;15594;0;22527;81050;195.0;2013;True;45;6.927350427350427
114.0;Katz Rudolf;1953;M5;HUN;Kanizsai Futóklub;Nagykanizsa;M;161;F4/9;6717;13647;0;20364;6861;14005;0;20866;5790;13375;0;19165;6979;15142;0;22121;82516;195.0;2013;True;60;7.052649572649573
115.0;Ajkay Antal;1950;M5;HUN;Sárvár Kinizsi SE;Budapest;M;102;F4/10;6451;13316;0;19767;6735;14167;0;20902;5652;13168;0;18820;7212;16026;0;23238;82727;195.0;2013;True;63;7.07068376068376
116.0;Teniak, Jozef;1947;M5;SVK;-;Kosice;M;293;F4/11;5492;12650;0;18142;6552;14051;0;20603;5510;12989;0;18499;6359;15096;0;21455;78699;195.0;2013;True;66;6.726410256410257
117.0;Koffein Kapitány;1979;M2;HUN;-;Eggersdorf;M;123;F2/44;6544;13179;0;19723;6817;0;0;6817;5654;13085;0;18739;7192;16452;0;23644;68923;195.0;2013;True;34;5.890854700854701
118.0;Dobay Attila;1971;M3;HUN;Spuri SC;Budapest;M;232;F3/62;6021;12714;0;18735;6290;13087;0;19377;5173;12933;0;18106;6801;15587;0;22388;78606;195.0;2013;True;42;6.718461538461538
24.0;Fejér Zsuzsa;1971;F3;HUN;-;Budapest;F;125;N3/14;6042;12890;0;18932;6800;13947;0;20747;5693;13520;0;19213;6966;16123;0;23089;81981;195.0;2013;True;42;7.006923076923076
25.0;Paraniak, Barbro;1956;F4;SWE;-;Huddinge;F;192;N4/1;6345;13537;0;19882;6796;13991;0;20787;5606;13483;0;19089;6923;15589;0;22512;82270;195.0;2013;True;57;7.031623931623932
119.0;Belvaracz Sándor;1968;M3;HUN;Kadarka Futóegyesület;Szekszárd;M;167;F3/63;6595;13864;0;20459;6775;13983;0;20758;5777;13525;0;19302;7307;16617;0;23924;84443;195.0;2013;True;45;7.217350427350428
120.0;Meiller, Johannes;1962;M4;AUT;-;Wien;M;109;F3/64;6222;13649;0;19871;6761;13949;0;20710;5683;13606;0;19289;7138;16771;0;23909;83779;195.0;2013;True;51;7.160598290598291
999.0;Carabinieri Matteo;1978;M2;HUN;Balatonfüredi Futó Cimborák & Barátaik;;M;158;;5789;11735;0;17524;5672;0;0;5672;3680;0;0;3680;0;11220;0;11220;38096;;2013;False;35;
999.0;Garami Csongor;1968;M3;HUN;-;Törökbálint;M;116;;5075;10786;0;15861;0;0;0;0;4696;11036;0;15732;0;0;0;0;31593;;2013;False;45;
999.0;Hegyesi Tamás;1966;M3;HUN;Ironteam SE;Őrbottyán;M;231;;6446;13188;0;19634;6809;0;0;6809;0;0;0;0;0;0;0;0;26443;;2013;False;47;
999.0;Maczó András;1949;M5;HUN;Zöldgömb SK;Budapest;M;26;;0;0;0;0;0;0;0;0;6068;0;0;6068;7602;16907;0;24509;30577;;2013;False;64;
999.0;Juhász Mihály dr.;1967;M3;HUN;-;Csongrád;M;160;;4633;11101;0;15734;6119;12731;0;18850;5299;12462;0;17761;0;0;0;0;52345;;2013;False;46;
999.0;Czabán László dr.;1968;M3;HUN;Jakabszállási Papírkutyák Triatlon Klub;Jakabszállás;M;112;;6813;13905;0;20718;0;0;0;0;5516;13405;0;18921;6936;15974;0;22910;62549;;2013;False;45;
999.0;Pavlokin Attila;1972;M3;HUN;-;Mohora;M;169;;5827;13148;0;18975;0;0;0;0;0;0;0;0;0;0;0;0;18975;;2013;False;41;
999.0;Mayer Brigitta;1976;F2;HUN;-;Mosonmagyaróvár;F;251;;4958;10665;0;15623;5838;11965;0;17803;4748;11891;0;16639;0;0;0;0;50065;;2013;False;37;
999.0;Veres István;1966;M3;HUN;-;Budapest;M;249;;5049;10576;0;15625;6097;12697;0;18794;4866;12455;0;17321;0;0;0;0;51740;;2013;False;47;
999.0;Bozó Pál;1939;M5;HUN;Futóbolondok SE;Erdőkertes;M;238;;6144;13261;0;19405;0;0;0;0;0;0;0;0;0;0;0;0;19405;;2013;False;74;
999.0;Wiesler, Peter;1955;M4;SWE;-;Akersberga;M;194;;6303;13251;0;19554;0;0;0;0;5554;13052;0;18606;7178;16409;0;23587;61747;;2013;False;58;
999.0;Berzy Judith;1973;F3;HUN;-;Budapest;F;22;;6092;13186;0;19278;0;0;0;0;0;0;0;0;0;0;0;0;19278;;2013;False;40;
999.0;Hack Román Antal;1974;M2;HUN;Hack-i mer az nyer;Nyergesújfalu;M;25;;5693;12942;0;18635;6701;14422;0;21123;0;0;0;0;6397;15201;0;21598;61356;;2013;False;39;
999.0;Kovács Nóra dr.;1970;F3;HUN;-;Budapest;F;145;;6044;12500;0;18544;0;0;0;0;4991;12055;0;17046;6356;14201;0;20557;56147;;2013;False;43;
999.0;Demeter Gábor;1970;M3;HUN;Jászberényi Triatlon;Jászberény;M;128;;5560;11090;0;16650;5573;11378;0;16951;0;0;0;0;12527;0;0;12527;46128;;2013;False;43;
999.0;Rakó Tamás;1974;M2;HUN;Nike Futóklub Tata;Tata;M;159;;6648;13688;0;20336;6789;13789;0;20578;5646;13618;0;19264;0;0;0;0;60178;;2013;False;39;
999.0;Heszberger Zalán;1973;M3;HUN;ELTE Polythlon Triatlon Klub;Budapest;M;103;;6285;13389;0;19674;6541;13725;0;20266;5562;13634;0;19196;0;0;0;0;59136;;2013;False;40;
999.0;Csuka Csaba;1968;M3;HUN;-;Szokolya;M;172;;4999;10403;0;15402;0;0;0;0;0;0;0;0;0;0;0;0;15402;;2013;False;45;
999.0;Práth Ádám;1975;M2;HUN;-;Üröm;M;156;;4833;9682;0;14515;4889;9668;0;14557;0;0;0;0;0;0;0;0;29072;;2013;False;38;
999.0;Sipos Balázs;1978;M2;HUN;TTT-HSE;Budapest;M;253;;4259;8623;0;12882;4568;9177;0;13745;0;0;0;0;0;0;0;0;26627;;2013;False;35;
999.0;Soós Péter;1970;M3;HUN;Honvéd Szondi SE;Székesfehérvár;M;273;;4985;0;0;4985;0;0;0;0;0;0;0;0;0;0;0;0;4985;;2013;False;43;
999.0;Szita János;1973;M3;HUN;Taszári Honvéd SE;Kaposvár;M;272;;5537;11949;0;17486;0;0;0;0;0;0;0;0;0;0;0;0;17486;;2013;False;40;
999.0;Timkó Zoltán;1954;M4;HUN;Ironteam SE;Budaörs;M;108;;5231;10780;0;16011;0;0;0;0;4749;10846;0;15595;6375;13961;0;20336;51942;;2013;False;59;
999.0;Gerencsér Miklós;1977;M2;HUN;ELTE Polythlon Triatlon Klub;Budapest;M;255;;5967;12451;0;18418;0;0;0;0;0;0;0;0;0;0;0;0;18418;;2013;False;36;
1.0;Steib Péter;1980;M2;HUN;SZUFLA;Szigetszentmárton;M;283;1 / F2;3389;7260;0;10649;4030;7892;0;11922;3142;7118;0;10260;3903;8426;0;12329;45160;195.0;2012;True;32;3.8598290598290594
2.0;Primozic, Lojze;1969;M3;SLO;3IRON;Zabnica;M;285;1 / F3;3506;7449;0;10955;4007;7940;0;11947;3330;7626;0;10956;4089;8948;0;13037;46895;195.0;2012;True;43;4.008119658119658
3.0;Bonfiglio, Marco;1977;M2;ITA;-;Milano;M;251;2 / F2;3497;7449;0;10946;4080;8012;0;12092;3344;7639;0;10983;4089;8948;0;13037;47058;195.0;2012;True;35;4.022051282051282
4.0;Ardzijauskas, Aidas;1971;M3;LTU;-;Vilnius;M;300;2 / F3;3564;7504;0;11068;0;8063;0;8063;3340;7646;0;10986;4066;8847;0;12913;43030;195.0;2012;True;41;3.6777777777777776
5.0;Peyer Zoltán;1980;M2;HUN;Oxygen wellness;Budapest;M;291;3 / F2;3571;7488;0;11059;4079;0;0;4079;3329;0;0;3329;4153;9470;0;13623;32090;195.0;2012;True;32;2.7427350427350428
6.0;Rudolf Tamás;1979;M2;HUN;Kanizsai Futóklub;Becsehely;M;182;4 / F2;3820;8160;0;11980;4136;8324;0;12460;3510;8053;0;11563;4104;0;0;4104;40107;195.0;2012;True;33;3.427948717948718
7.0;Lakatos Roland;1977;M2;HUN;Zalaegeszegi Aszfaltszaggatók;Zalaegerszeg;M;146;5 / F2;4096;8652;0;12748;4412;8773;0;13185;3666;8362;0;12028;4365;9783;0;14148;52109;195.0;2012;True;35;4.453760683760684
8.0;Vakhal Norbert;1979;M2;HUN;Honvéd Szondi SE;Székesfehérvár;M;267;6 / F2;4297;9072;0;13369;4529;9141;0;13670;3698;8449;0;12147;4455;9777;0;14232;53418;195.0;2012;True;33;4.565641025641026
9.0;Starek, Martin;1980;M2;CZE;TERC;Prague 3;M;224;7 / F2;3565;7683;0;11248;4379;8935;0;13314;3934;9309;0;13243;4793;10548;0;15341;53146;195.0;2012;True;32;4.542393162393163
10.0;Ridel, Jakub;1975;M2;CZE;TERC;Prague;M;217;8 / F2;3431;7488;0;10919;4275;8978;0;13253;3387;8271;0;11658;4476;10776;0;15252;51082;195.0;2012;True;37;4.365982905982906
11.0;Herget, Thomas;1967;M3;GER;LG Fulda;Fulda;M;253;3 / F3;4035;8738;0;12773;4300;8690;0;12990;3648;8641;0;12289;4484;10180;0;14664;52716;195.0;2012;True;45;4.505641025641026
12.0;Papp Sándor;1970;M3;HUN;Debreceni Rendőr SE;Vámospércs;M;214;4 / F3;4005;8548;0;12553;4742;9563;0;14305;3812;8754;0;12566;4573;10057;0;14630;54054;195.0;2012;True;42;4.62
13.0;Baranyai Krisztián;1975;M2;HUN;MH 86.Szolnok Helikopter Bázis-Honvéd SE;Törtel;M;272;9 / F2;3865;8223;0;12088;4490;8995;0;13485;3819;9013;0;12832;5165;11014;0;16179;54584;195.0;2012;True;37;4.665299145299145
14.0;Belej Bálint;1977;M2;HUN;-;Budapest;M;157;10 / F2;3495;8248;0;11743;4535;8915;0;13450;3551;8785;0;12336;4462;9779;0;14241;51770;195.0;2012;True;35;4.424786324786325
15.0;Pintér Tibor;1977;M2;HUN;Micro SC;Budapest;M;207;11 / F2;4083;8680;0;12763;4693;9516;0;14209;3851;9064;0;12915;4697;10683;0;15380;55267;195.0;2012;True;35;4.723675213675214
16.0;Herbák Gergő;1980;M2;HUN;Gróf Hadik András SE;Budajenő;M;295;12 / F2;3623;8328;0;11951;4420;9398;0;13818;3649;8960;0;12609;4514;10396;0;14910;53288;195.0;2012;True;32;4.5545299145299145
17.0;Rumi Mihály Róbert;1974;M2;HUN;Sunderland Strollers;Gárdony;M;9;13 / F2;4294;9073;0;13367;4967;9920;0;14887;4088;9463;0;13551;5062;11110;0;16172;57977;195.0;2012;True;38;4.955299145299145
18.0;Simon Zoltán;1970;M3;HUN;-;Solymár;M;37;5 / F3;4342;9115;0;13457;5169;10150;0;15319;4159;9438;0;13597;5120;10929;0;16049;58422;195.0;2012;True;42;4.993333333333333
19.0;Pók János;1963;M3;HUN;Axiál Kft.;Gárdony (Agárd);M;33;6 / F3;4300;9078;0;13378;4964;9921;0;14885;4107;9481;0;13588;5063;11526;0;16589;58440;195.0;2012;True;49;4.994871794871795
20.0;Kovács Réka;1980;F2;HUN;-;Wien;F;141;1 / N2;4281;9131;0;13412;4720;9477;0;14197;4022;9463;0;13485;5010;11226;0;16236;57330;195.0;2012;True;32;4.9
21.0;Kerekes László;1967;M3;HUN;-;Szekszárd;M;143;7 / F3;4274;0;0;4274;4986;9972;0;14958;4055;9310;0;13365;5178;11454;0;16632;49229;195.0;2012;True;45;4.207606837606837
22.0;Tigyi László;1960;M4;HUN;Nudlik SE;Budapest;M;194;8 / F3;4149;8886;0;13035;4958;10158;0;15116;3962;9362;0;13324;4771;10786;0;15557;57032;195.0;2012;True;52;4.874529914529915
23.0;Jameson, Iveagh;1970;M3;IRL;-;Bailieborough;M;236;9 / F3;5159;10524;0;15683;5339;0;0;5339;4172;9532;0;13704;4997;10716;0;15713;50439;195.0;2012;True;42;4.311025641025641
24.0;Gömöri, József;1964;M3;SRB;Magyarkanizsa;Magyarkanizsa;M;139;10 / F3;4147;8953;0;13100;5163;9692;0;14855;4491;9877;0;14368;5211;10480;0;15691;58014;195.0;2012;True;48;4.958461538461538
25.0;Salamon István;1962;M3;HUN;-;Mezőtárkány;M;34;11 / F3;4363;9184;0;13547;5166;10314;0;15480;4097;9418;0;13515;5121;11073;0;16194;58736;195.0;2012;True;50;5.02017094017094
26.0;Sipos Sándor;1957;M4;HUN;HASE;Budapest;M;268;12 / F3;4419;9427;0;13846;5180;10411;0;15591;4161;9640;0;13801;5357;11832;0;17189;60427;195.0;2012;True;55;5.164700854700855
27.0;Máténé Varju Edit;1971;F3;HUN;Honvéd Szondi SE;Székesfehérvár;F;274;1 / N3;4395;9469;0;13864;5180;10370;0;15550;4136;9691;0;13827;5138;11588;0;16726;59967;195.0;2012;True;41;5.125384615384616
28.0;Szarvas Mátyás;1961;M4;HUN;-;Keszthely;M;244;13 / F3;4422;9438;0;13860;5236;10601;0;15837;4261;9972;0;14233;5357;11850;0;17207;61137;195.0;2012;True;51;5.225384615384615
29.0;Dezső Sándor;1965;M3;HUN;-;Hódmezővásárhely;M;158;14 / F3;3858;8684;0;12542;4653;9457;0;14110;4156;9725;0;13881;5070;11632;0;16702;57235;195.0;2012;True;47;4.891880341880341
30.0;Hegyi Loránd;1974;M2;HUN;-;Szolnok;M;128;14 / F2;4585;9735;0;14320;5196;10570;0;15766;4194;9597;0;13791;5377;11962;0;17339;61216;195.0;2012;True;38;5.232136752136752
31.0;Domán Gábor;1960;M4;HUN;Tapolca Honvéd SE;Tapolca;M;101;15 / F3;4015;8684;0;12699;4663;9462;0;14125;4009;9682;0;13691;4887;0;0;4887;45402;195.0;2012;True;52;3.8805128205128208
32.0;Kádár-Csoboth Péter;1978;M2;HUN;Futóbolondok SE;Budapest;M;155;15 / F2;0;9796;0;9796;5379;10662;0;16041;4393;10055;0;14448;5437;12135;0;17572;57857;195.0;2012;True;34;4.945042735042735
33.0;Windisch, Ralf;1969;M3;GER;Therme LT Böblingen;Grafenau;M;209;16 / F3;4745;9953;0;14698;5512;11073;0;16585;4381;9925;0;14306;5459;11951;0;17410;62999;195.0;2012;True;43;5.384529914529915
34.0;Szőke Tamás;1970;M3;HUN;Szondi SE;Székesfehérvár;M;14;17 / F3;4617;9802;0;14419;4989;9994;0;14983;4120;9920;0;14040;5520;12089;0;17609;61051;195.0;2012;True;42;5.218034188034188
35.0;Máthé Zoltán;1974;M2;HUN;-;Budapest;M;192;16 / F2;4731;10125;0;14856;5469;11138;0;16607;4373;9861;0;14234;5295;11581;0;16876;62573;195.0;2012;True;38;5.348119658119659
36.0;Druskó Zsófia;1966;F3;HUN;Fővárosi Vízművek SK;Törökbálint;F;242;2 / N3;4424;9667;0;14091;5187;10561;0;15748;4415;10297;0;14712;5343;11905;0;17248;61799;195.0;2012;True;46;5.281965811965812
37.0;Huszty Béla;1964;M3;HUN;KELE;Kalocsa;M;255;18 / F3;4582;0;0;4582;5438;10741;0;16179;4404;10213;0;14617;5229;11579;0;16808;52186;195.0;2012;True;48;4.46034188034188
38.0;Gyúri Attila;1977;M2;HUN;Masterfield Oktatóközpont;Budapest;M;138;17 / F2;4777;10097;0;14874;5490;11021;0;16511;4484;10375;0;14859;5310;11679;0;16989;63233;195.0;2012;True;35;5.404529914529915
39.0;Pintér Sándor;1975;M2;HUN;Pénzügyőr SE;Gödöllő;M;260;18 / F2;3856;8644;0;12500;4860;10635;0;15495;4352;10513;0;14865;4981;12332;0;17313;60173;195.0;2012;True;37;5.142991452991453
40.0;Mayer, Georg;1969;M3;AUT;PSV Leoben;Vienna;M;230;19 / F3;3997;8637;0;12634;4826;10108;0;14934;4281;9818;0;14099;6287;13504;0;19791;61458;195.0;2012;True;43;5.252820512820513
41.0;Mohr, Christian;1968;M3;GER;LG DUV;Hamburg;M;234;20 / F3;5177;11023;0;16200;5536;11049;0;16585;4480;10400;0;14880;5463;11954;0;17417;65082;195.0;2012;True;44;5.562564102564103
42.0;Kiss Péter;1986;M1;HUN;Margita 344,2 TSE;Gyöngyös;M;17;19 / F2;4201;9112;0;13313;5297;10939;0;16236;4319;9870;0;14189;5180;11999;0;17179;60917;195.0;2012;True;26;5.206581196581197
43.0;Török Tibor;1985;M1;HUN;Kalocsai SE;Kalocsa;M;154;20 / F2;4003;9012;0;13015;5149;10921;0;16070;4199;10316;0;14515;5206;12164;0;17370;60970;195.0;2012;True;27;5.211111111111111
44.0;Farkas László;1967;M3;HUN;Futóbolondok SE;Budapest;M;20;21 / F3;4578;9798;0;14376;0;10806;0;10806;4508;10510;0;15018;5519;12277;0;17796;57996;195.0;2012;True;45;4.956923076923077
45.0;Láng István;1957;M4;HUN;FFTC;Göd (Alsógöd);M;30;22 / F3;4574;9797;0;14371;5432;10921;0;16353;4509;10508;0;15017;5524;12275;0;17799;63540;195.0;2012;True;55;5.430769230769231
46.0;Germán László;1977;M2;HUN;-;Budapest;M;131;21 / F2;4434;9392;0;13826;5062;10078;0;15140;4262;10173;0;14435;5944;13738;0;19682;63083;195.0;2012;True;35;5.391709401709402
47.0;Révhegyi Zoltán;1971;M3;HUN;Baltazár SC;Budapest;M;211;23 / F3;4712;10236;0;14948;5592;11485;0;17077;4408;10297;0;14705;5560;12487;0;18047;64777;195.0;2012;True;41;5.536495726495726
48.0;Czoske, Jörg;1959;M4;GER;-;Holldorf;M;225;24 / F3;4743;9953;0;14696;5513;11070;0;16583;4373;10084;0;14457;5459;12491;0;17950;63686;195.0;2012;True;53;5.443247863247864
49.0;Czaltig Zsolt;1974;M2;HUN;-;Százhalombatta;M;129;22 / F2;4706;10257;0;14963;5489;11138;0;16627;4442;10349;0;14791;5478;12113;0;17591;63972;195.0;2012;True;38;5.467692307692308
50.0;Gyurján Tamás;1980;M2;HUN;-;Budapest;M;266;23 / F2;4756;10092;0;14848;5390;10845;0;16235;4410;10371;0;14781;5318;11853;0;17171;63035;195.0;2012;True;32;5.387606837606837
51.0;Bakó Gábor;1968;M3;HUN;-;Pomáz;M;115;25 / F3;4682;0;0;4682;5316;10983;0;16299;4213;9971;0;14184;5416;12380;0;17796;52961;195.0;2012;True;44;4.526581196581196
52.0;Soós Péter;1970;M3;HUN;Honvéd Szondi SE;Székesfehérvár;M;276;26 / F3;4859;9976;0;14835;5377;10999;0;16376;4415;0;0;4415;5805;13120;0;18925;54551;195.0;2012;True;42;4.662478632478632
53.0;Vadász Attila;1964;M3;HUN;Tapolca Honvéd SE;Szigliget;M;269;27 / F3;4188;9182;0;13370;5241;10719;0;15960;4216;10950;0;15166;5423;12629;0;18052;62548;195.0;2012;True;48;5.345982905982906
54.0;Marosi Péter;1975;M2;HUN;IKEA FC;Baja;M;241;24 / F2;4721;9945;0;14666;5457;11031;0;16488;4452;0;0;4452;5649;12567;0;18216;53822;195.0;2012;True;37;4.60017094017094
55.0;Zandbergen, Robert;1963;M3;NED;-;Rijnsburg;M;229;28 / F3;4467;9458;0;13925;5663;11433;0;17096;4282;10165;0;14447;5527;12475;0;18002;63470;195.0;2012;True;49;5.424786324786324
56.0;Müller-Wechser, Peter;1959;M4;GER;-;;M;247;29 / F3;4847;10429;0;15276;5549;11079;0;16628;4553;10631;0;15184;5774;12463;0;18237;65325;195.0;2012;True;53;5.583333333333333
57.0;Luber, Anton;1965;M3;GER;-;;M;235;30 / F3;4850;10433;0;15283;5552;11080;0;16632;4554;10633;0;15187;5774;12463;0;18237;65339;195.0;2012;True;47;5.584529914529915
58.0;Ozsvár Tihamér;1969;M3;HUN;-;Csantavér;M;149;31 / F3;5105;10671;0;15776;5849;11359;0;17208;4690;10767;0;15457;5673;12473;0;18146;66587;195.0;2012;True;43;5.691196581196581
59.0;Tóth Iván Csaba;1974;M2;HUN;Vasemberek Klubja;Fót;M;202;25 / F2;4803;10197;0;15000;5749;11492;0;17241;4724;10569;0;15293;5814;12758;0;18572;66106;195.0;2012;True;38;5.65008547008547
60.0;Kolonics Tamás;1971;M3;HUN;-;Váchartyán;M;186;32 / F3;4845;10201;0;15046;5577;11207;0;16784;4728;10663;0;15391;5813;12759;0;18572;65793;195.0;2012;True;41;5.623333333333333
61.0;Nixon, Rosemary;1968;F3;GBR;-;Annecy;F;231;3 / N3;4704;10082;0;14786;5488;11130;0;16618;4401;10555;0;14956;5674;12646;0;18320;64680;195.0;2012;True;44;5.528205128205128
62.0;Gáti Levente;1959;M4;HUN;ALLTECH;Budapest;M;144;33 / F3;4673;10006;0;14679;5597;11470;0;17067;4390;10319;0;14709;5349;12082;0;17431;63886;195.0;2012;True;53;5.46034188034188
63.0;Veress Béla;1977;M2;HUN;-;Budapest;M;147;26 / F2;4372;9468;0;13840;5351;10896;0;16247;4458;11018;0;15476;5352;11815;0;17167;62730;195.0;2012;True;35;5.361538461538461
64.0;Kollár Szabolcs;1970;M3;HUN;-;Budapest;M;215;34 / F3;4772;10289;0;15061;5775;11458;0;17233;4684;10435;0;15119;5318;11668;0;16986;64399;195.0;2012;True;42;5.504188034188034
65.0;Vakhal György;1955;M4;HUN;Honvéd Rákóczi SE;Szentes;M;278;1 / F4;4302;9280;0;13582;5126;10722;0;15848;4103;10040;0;14143;5284;0;0;5284;48857;195.0;2012;True;57;4.175811965811966
66.0;Erdei, Ferencz;1975;M2;ROM;Zebra Futóklub;Budapest;M;205;27 / F2;5351;11109;0;16460;5586;11188;0;16774;4644;10765;0;15409;5844;12057;0;17901;66544;195.0;2012;True;37;5.687521367521367
67.0;Horváth Monika;1966;F3;HUN;MOGYI SE;Baja;F;130;4 / N3;4856;10207;0;15063;5687;11275;0;16962;4658;10729;0;15387;5803;13166;0;18969;66381;195.0;2012;True;46;5.673589743589743
68.0;Jallow, Alasaine;1947;M5;GAM;-;Serrekunda;M;197;2 / F4;4580;10043;0;14623;5288;10959;0;16247;4405;10606;0;15011;5440;12507;0;17947;63828;195.0;2012;True;65;5.455384615384615
69.0;Mészáros Zoltán;1978;M2;HUN;Honvéd Aurora SE;Szigetszentmiklós;M;281;28 / F2;5125;10910;0;16035;5788;11442;0;17230;4584;10749;0;15333;5885;12745;0;18630;67228;195.0;2012;True;34;5.745982905982906
70.0;Szabó Krisztina dr.;1971;F3;HUN;-;Budapest;F;135;5 / N3;4717;10293;0;15010;5573;11451;0;17024;4510;10836;0;15346;5560;12488;0;18048;65428;195.0;2012;True;41;5.592136752136752
71.0;Klam Csaba;1970;M3;HUN;-;Soltvadkert;M;29;35 / F3;4493;9615;0;14108;5758;11933;0;17691;4529;10925;0;15454;5598;12684;0;18282;65535;195.0;2012;True;42;5.601282051282051
72.0;Fekete Gábor;1957;M4;HUN;Margita 344,2 TSE;Veresegyház;M;206;36 / F3;4375;9571;0;13946;5474;11008;0;16482;4426;10600;0;15026;5311;13052;0;18363;63817;195.0;2012;True;55;5.4544444444444435
73.0;Komjáti Sándor dr;1964;M3;HUN;Tapolca Honvéd SE;Tapolca;M;270;37 / F3;4841;10681;0;15522;5796;11442;0;17238;4662;0;0;4662;5707;12511;0;18218;55640;195.0;2012;True;48;4.7555555555555555
74.0;Hegedűs József;1963;M3;HUN;FFTC;Dunaföldvár;M;200;38 / F3;5021;10828;0;15849;5695;11544;0;17239;4798;11089;0;15887;5784;12940;0;18724;67699;195.0;2012;True;49;5.786239316239316
75.0;Zömbik László;1961;M4;HUN;-;Keszthely;M;254;39 / F3;5109;10773;0;15882;5778;11501;0;17279;4702;11154;0;15856;5901;13230;0;19131;68148;195.0;2012;True;51;5.8246153846153845
76.0;Valkai Eszter;1985;F1;HUN;-;Kedington;F;118;2 / N2;4772;10285;0;15057;5769;11541;0;17310;4757;11245;0;16002;5955;13189;0;19144;67513;195.0;2012;True;27;5.7703418803418804
77.0;Mayer Brigitta;1976;F2;HUN;-;Mosonmagyaróvár;F;153;3 / N2;4779;10288;0;15067;5767;11539;0;17306;4759;11249;0;16008;5953;13186;0;19139;67520;195.0;2012;True;36;5.770940170940171
78.0;Vollár Gyula;1971;M3;HUN;Vasemberek Klubja;Pécel;M;132;40 / F3;5214;11089;0;16303;5898;11791;0;17689;4740;11221;0;15961;5694;12760;0;18454;68407;195.0;2012;True;41;5.846752136752136
79.0;Balogh Ádám;1979;M2;HUN;BKV Előre SC;Budapest;M;187;29 / F2;5018;10741;0;15759;5658;11515;0;17173;4262;10376;0;14638;5295;13111;0;18406;65976;195.0;2012;True;33;5.638974358974359
80.0;Kósa Judit dr.;1961;F3;HUN;Bárdos DSE;Budapest;F;262;6 / N3;4809;10482;0;15291;5662;11462;0;17124;4710;0;0;4710;5605;12908;0;18513;55638;195.0;2012;True;51;4.7553846153846155
81.0;Gerencsér Miklós;1977;M2;HUN;Polythlon;Budapest;M;156;30 / F2;4566;10257;0;14823;5645;11563;0;17208;0;11280;0;11280;5316;12438;0;17754;61065;195.0;2012;True;35;5.219230769230769
82.0;Leskovics Józsefné Andrea;1968;F3;HUN;LESI SE;Budapest;F;201;7 / N3;4944;10804;0;15748;5816;0;0;5816;4934;11646;0;16580;6116;13515;0;19631;57775;195.0;2012;True;44;4.938034188034188
83.0;Vavrochova, Monika;1968;F3;CZE;-;Prague;F;223;8 / N3;4297;9462;0;13759;5657;11557;0;17214;4646;11230;0;15876;6234;13999;0;20233;67082;195.0;2012;True;44;5.733504273504273
84.0;Koncz Levente;1974;M2;HUN;-;Budapest;M;208;31 / F2;4783;10143;0;14926;6064;12249;0;18313;5156;11996;0;17152;6264;13634;0;19898;70289;195.0;2012;True;38;6.007606837606838
85.0;Czégény Erzsébet;1967;F3;HUN;Elite fitt;Békéscsaba;F;284;9 / N3;4898;10799;0;15697;5701;11736;0;17437;4820;11505;0;16325;5795;12966;0;18761;68220;195.0;2012;True;45;5.8307692307692305
86.0;Olcsák József;1978;M2;HUN;Vasemberek Klubja;Tiszatenyő;M;105;32 / F2;4978;10741;0;15719;5980;12164;0;18144;5136;11977;0;17113;6263;13637;0;19900;70876;195.0;2012;True;34;6.057777777777778
87.0;Kollár Zoltán;1965;M3;HUN;Knorr-Bremse;Budapest;M;55;41 / F3;5451;11798;0;17249;6202;12442;0;18644;5187;11907;0;17094;5973;13112;0;19085;72072;195.0;2012;True;47;6.16
88.0;Simon Péter;1965;M3;HUN;-;Budapest;M;249;42 / F3;4714;10232;0;14946;5753;11630;0;17383;4818;11430;0;16248;5704;13015;0;18719;67296;195.0;2012;True;47;5.751794871794871
89.0;Lovas Mátyás;1979;M2;HUN;OSE Kószák;Oroszlány;M;148;33 / F2;5353;11382;0;16735;6042;12143;0;18185;5106;11510;0;16616;6000;12948;0;18948;70484;195.0;2012;True;33;6.024273504273505
90.0;Von Uleniecki, Alexander;1968;M3;GER;-;Berlin;M;227;43 / F3;5817;12028;0;17845;6119;12414;0;18533;4817;10893;0;15710;6259;13619;0;19878;71966;195.0;2012;True;44;6.150940170940172
91.0;Scheffer István;1960;M4;HUN;PAFF;Paks;M;292;44 / F3;4902;10517;0;15419;5920;12072;0;17992;4844;11759;0;16603;5805;12846;0;18651;68665;195.0;2012;True;52;5.868803418803419
92.0;Kreszta Zoltán;1970;M3;HUN;UTE;Budapest;M;11;45 / F3;4751;10161;0;14912;5742;11519;0;17261;4620;11100;0;15720;5851;13526;0;19377;67270;195.0;2012;True;42;5.74957264957265
93.0;Berki Zoltán;1977;M2;HUN;-;Debrecen;M;261;34 / F2;4591;10089;0;14680;0;11814;0;11814;4880;11778;0;16658;5938;0;0;5938;49090;195.0;2012;True;35;4.195726495726496
94.0;Szabó Zoltán dr;1958;M4;HUN;-;Dunaújváros;M;240;46 / F3;4843;10270;0;15113;5900;12034;0;17934;4873;11360;0;16233;5938;13743;0;19681;68961;195.0;2012;True;54;5.894102564102564
95.0;Rabi István;1973;M2;HUN;FFTC;Dunaújváros;M;256;35 / F2;4041;9112;0;13153;4992;10280;0;15272;4070;10243;0;14313;5175;11458;0;16633;59371;195.0;2012;True;39;5.0744444444444445
96.0;Kóti István;1966;M3;HUN;-;Dunaújváros;M;185;47 / F3;5195;11333;0;16528;6188;12603;0;18791;5166;11971;0;17137;6130;13909;0;20039;72495;195.0;2012;True;46;6.196153846153846
97.0;Fazekas János;1968;M3;HUN;Vasemberek Klubja;Budapest;M;107;48 / F3;5577;11996;0;17573;6176;12525;0;18701;4260;9742;0;14002;6558;14976;0;21534;71810;195.0;2012;True;44;6.137606837606837
98.0;Vajas, Roland;1976;M2;SVK;Csallóközi Marathon Club;Dunajská Streda;M;112;36 / F2;4744;10244;0;14988;5715;11787;0;17502;4767;11540;0;16307;6222;15354;0;21576;70373;195.0;2012;True;36;6.014786324786325
99.0;Kuthy Péter;1975;M2;HUN;-;Budapest;M;288;37 / F2;4441;10442;0;14883;6201;12440;0;18641;5149;11885;0;17034;5974;13177;0;19151;69709;195.0;2012;True;37;5.958034188034188
100.0;Vissers, Wilma;1963;F3;NED;-;Illgau;F;216;10 / N3;4878;10550;0;15428;5849;11907;0;17756;4894;11500;0;16394;6256;14874;0;21130;70708;195.0;2012;True;49;6.043418803418803
101.0;Bódis Tamás;1988;M1;HUN;MH 86.Szolnok Helikopter Bázis-Honvéd SE;Hangony;M;273;1 / F1;3868;8811;0;12679;5813;11556;0;17369;5441;12852;0;18293;6616;15371;0;21987;70328;195.0;2012;True;24;6.010940170940171
102.0;Blaskó Mihály;1980;M2;HUN;-;Budapest;M;286;38 / F2;5491;11861;0;17352;5936;12083;0;18019;5018;11879;0;16897;6581;14351;0;20932;73200;195.0;2012;True;32;6.256410256410256
103.0;Schuh Gábor Ferenc;1979;M2;HUN;Répcelaki SE;Répcelak;M;258;39 / F2;5128;10912;0;16040;5932;12607;0;18539;5148;12341;0;17489;6326;13712;0;20038;72106;195.0;2012;True;33;6.162905982905983
104.0;Popovics Gábor;1977;M2;HUN;-;Budapest;M;287;40 / F2;4919;10737;0;15656;5951;12654;0;18605;5007;11640;0;16647;6147;14462;0;20609;71517;195.0;2012;True;35;6.112564102564103
105.0;Ekstam, Jonas;1963;M3;SWE;-;Karlstad;M;277;49 / F3;4777;0;0;4777;5923;12256;0;18179;5072;12330;0;17402;5738;13660;0;19398;59756;195.0;2012;True;49;5.107350427350427
106.0;Paraniak, Jan;1950;M5;SWE;-;Huddinge;M;222;3 / F4;5012;11267;0;16279;5897;12450;0;18347;4613;11959;0;16572;5669;13622;0;19291;70489;195.0;2012;True;62;6.024700854700854
107.0;Ramoska, Povilas;1957;M4;LTU;-;Vilnius;M;237;50 / F3;5141;11542;0;16683;5887;12256;0;18143;4794;11389;0;16183;5802;13321;0;19123;70132;195.0;2012;True;55;5.994188034188034
108.0;Szabó Balázs dr.;1970;M3;HUN;-;Budapest;M;103;51 / F3;5115;10957;0;16072;6002;12495;0;18497;5377;12715;0;18092;6770;15078;0;21848;74509;195.0;2012;True;42;6.368290598290598
109.0;Prekopp Péter Dr.;1978;M2;HUN;-;Budapest;M;133;41 / F2;5115;10958;0;16073;6005;12496;0;18501;5375;12718;0;18093;6770;15073;0;21843;74510;195.0;2012;True;34;6.368376068376068
110.0;Varga Máté;1976;M2;HUN;-;Gyermely;M;120;42 / F2;4279;10002;0;14281;5210;11721;0;16931;4918;12433;0;17351;5985;14225;0;20210;68773;195.0;2012;True;36;5.878034188034188
111.0;Reim, Annette;1968;F3;GER;TSV Simmozheim;Simmozheim;F;232;11 / N3;5120;11061;0;16181;6033;12419;0;18452;4953;11909;0;16862;5994;14756;0;20750;72245;195.0;2012;True;44;6.174786324786324
112.0;Járosi Tamás;1973;M2;HUN;Zebra Futóklub;Nagykanizsa;M;109;43 / F2;4807;10894;0;15701;5585;12765;0;18350;4823;12108;0;16931;6157;15070;0;21227;72209;195.0;2012;True;39;6.171709401709402
113.0;Takács Edina;1972;F3;HUN;-;Dévaványa;F;140;4 / N2;5236;0;0;5236;6191;12611;0;18802;5163;11965;0;17128;6127;14246;0;20373;61539;195.0;2012;True;40;5.25974358974359
114.0;Balkai Dániel;1986;M1;HUN;LapáTolók SE;Érd;M;203;44 / F2;4901;10659;0;15560;6048;12420;0;18468;5041;12191;0;17232;6711;15545;0;22256;73516;195.0;2012;True;26;6.283418803418804
115.0;Nedeczky László Tamás;1984;M2;HUN;-;Budapest;M;250;45 / F2;5530;12153;0;17683;6582;13314;0;19896;5381;12659;0;18040;6125;13495;0;19620;75239;195.0;2012;True;28;6.430683760683761
116.0;Pálffy Tibor;1953;M4;HUN;Margita 344,2 TSE;Gödöllő;M;16;4 / F4;4988;10726;0;15714;5860;12191;0;18051;5376;12977;0;18353;6371;14503;0;20874;72992;195.0;2012;True;59;6.2386324786324785
117.0;Köves Péter;1972;M3;HUN;Kaposvári Atlétikai Club;Nagykanizsa;M;114;52 / F3;4496;9343;0;13839;5477;0;0;5477;5072;12933;0;18005;6648;15419;0;22067;59388;195.0;2012;True;40;5.075897435897436
118.0;Jánosi Kornél dr.;1964;M3;HUN;Buda Fitness;Szentendre;M;125;53 / F3;5577;11953;0;17530;6176;12525;0;18701;5282;12345;0;17627;6558;14974;0;21532;75390;195.0;2012;True;48;6.443589743589744
119.0;Posztobányi Zoltán;1963;M3;HUN;KELE;Kalocsa;M;150;54 / F3;4837;10957;0;15794;6183;13327;0;19510;4846;11795;0;16641;6092;14128;0;20220;72165;195.0;2012;True;49;6.167948717948718
120.0;Billson, Simon;1976;M2;GBR;MVH Tri;Unterschleissheim;M;181;46 / F2;4697;10156;0;14853;6241;14162;0;20403;4528;11073;0;15601;6415;15624;0;22039;72896;195.0;2012;True;36;6.230427350427351
121.0;Horváth János;1959;M4;HUN;FittBike Se;Pécsbagota;M;279;55 / F3;5121;11103;0;16224;5619;11571;0;17190;5374;12720;0;18094;5984;13377;0;19361;70869;195.0;2012;True;53;6.0571794871794875
122.0;Polgár Sándor;1956;M4;HUN;Versenycsigák;Törökszentmiklós;M;243;5 / F4;5595;12118;0;17713;6511;13036;0;19547;5247;12596;0;17843;6535;14924;0;21459;76562;195.0;2012;True;56;6.543760683760683
123.0;Timkó Zoltán;1954;M4;HUN;Futóbolondok SE;Budaörs;M;121;6 / F4;4998;11054;0;16052;6072;12671;0;18743;5047;12273;0;17320;5997;14325;0;20322;72437;195.0;2012;True;58;6.191196581196581
124.0;Kecskés László;1964;M3;HUN;-;Budapest;M;117;56 / F3;4997;11058;0;16055;6073;12674;0;18747;5053;12284;0;17337;5997;14428;0;20425;72564;195.0;2012;True;48;6.202051282051283
125.0;Morócz József;1969;M3;HUN;SZUFLA;Budapest;M;193;57 / F3;4682;10092;0;14774;5937;12495;0;18432;5812;13467;0;19279;6925;16137;0;23062;75547;195.0;2012;True;43;6.457008547008546
126.0;Zlinszky András;1983;M2;HUN;Regnum Marianum SE;Tihany;M;248;47 / F2;5478;12033;0;17511;6518;13479;0;19997;5377;0;0;5377;6706;0;0;6706;49591;195.0;2012;True;29;4.238547008547008
127.0;Alnebring, Robert;1958;M4;SWE;-;Uppsala;M;218;58 / F3;4843;10591;0;15434;6314;13703;0;20017;5315;0;0;5315;6102;14167;0;20269;61035;195.0;2012;True;54;5.216666666666667
128.0;Ajkay Antal;1950;M5;HUN;Sárvár Kinizsi SE;Budapest;M;102;7 / F4;5568;12053;0;17621;6666;13845;0;20511;5478;13337;0;18815;6709;15101;0;21810;78757;195.0;2012;True;62;6.731367521367521
129.0;Budenszki Péter;1973;M2;HUN;MAC;Budapest;M;152;48 / F2;5241;11357;0;16598;6775;13569;0;20344;5246;12864;0;18110;6858;16080;0;22938;77990;195.0;2012;True;39;6.665811965811965
130.0;Séra István;1960;M4;HUN;-;Budapest;M;36;59 / F3;5473;12110;0;17583;6553;13818;0;20371;5469;13250;0;18719;6704;15694;0;22398;79071;195.0;2012;True;52;6.758205128205128
131.0;Szekeres Nyúl;1967;F3;HUN;Futóbolondok SE;Budapest;F;122;12 / N3;5477;12118;0;17595;6550;13819;0;20369;5488;13275;0;18763;6704;15695;0;22399;79126;195.0;2012;True;45;6.762905982905983
132.0;Koffein Kapitány;1979;M2;HUN;-;Szajol;M;113;49 / F2;5831;0;0;5831;6756;13989;0;20745;5710;13736;0;19446;7166;16349;0;23515;69537;195.0;2012;True;33;5.943333333333333
133.0;Sólyom Zoltán;1972;M3;HUN;Ikarus BSE;Budapest;M;245;60 / F3;5220;12059;0;17279;6388;13707;0;20095;5688;13819;0;19507;7286;16331;0;23617;80498;195.0;2012;True;40;6.880170940170941
134.0;Bálint Zsolt;1970;M3;HUN;-;Dunaharaszti;M;280;61 / F3;5217;11809;0;17026;6778;14367;0;21145;5608;0;0;5608;6651;15759;0;22410;66189;195.0;2012;True;42;5.657179487179488
135.0;Berzy Judith;1973;F2;HUN;-;Budapest;F;22;5 / N2;5387;12159;0;17546;6118;13593;0;19711;5382;14016;0;19398;6488;15458;0;21946;78601;195.0;2012;True;39;6.718034188034188
136.0;Gnauert, René;1972;M3;GER;-;Berlin;M;191;50 / F2;6113;12943;0;19056;6767;14203;0;20970;5494;13184;0;18678;6815;16157;0;22972;81676;195.0;2012;True;40;6.9808547008547
137.0;Leffler, Mirko;1970;M3;GER;-;Suhl;M;188;62 / F3;6204;14362;0;20566;6506;13915;0;20421;5753;14039;0;19792;6876;15549;0;22425;83204;195.0;2012;True;42;7.111452991452992
138.0;Bicher, Stefan;1982;M2;GER;-;Berlin;M;190;51 / F2;6205;14330;0;20535;6512;13919;0;20431;5787;14032;0;19819;7106;0;0;7106;67891;195.0;2012;True;30;5.802649572649573
139.0;Deák, Andreas;1963;M3;GER;-;Berlin;M;213;63 / F3;5814;12024;0;17838;6940;14220;0;21160;5555;13392;0;18947;6814;16157;0;22971;80916;195.0;2012;True;49;6.915897435897436
140.0;Paraniak, Barbro;1956;F4;SWE;-;Huddinge;F;221;13 / N3;5946;13021;0;18967;0;13856;0;13856;5684;13669;0;19353;6861;16046;0;22907;75083;195.0;2012;True;56;6.417350427350428
141.0;Fenyő István;1963;M3;HUN;-;Mucsi;M;184;64 / F3;4934;0;0;4934;6538;14354;0;20892;5792;14090;0;19882;6448;15712;0;22160;67868;195.0;2012;True;49;5.800683760683762
142.0;Bozó Pál;1939;M5;HUN;Futóbolondok SE;Erdőkertes;M;204;8 / F4;5392;12129;0;17521;6650;14007;0;20657;5629;14302;0;19931;6937;16850;0;23787;81896;195.0;2012;True;73;6.99965811965812
143.0;Lajszner Lajos;1966;M3;HUN;-;Eger;M;239;65 / F3;5477;12484;0;17961;6661;14369;0;21030;5560;14056;0;19616;6903;16399;0;23302;81909;195.0;2012;True;46;7.000769230769231
999.0;Beelitz, Ralf;1963;M3;GER;-;Berlin;M;189;68 / F3;6132;13464;0;19596;6758;14538;0;21296;0;0;0;0;6890;15527;0;22417;63309;150.0;2012;False;49;7.0343333333333335
999.0;Lukovics Béla;1953;M4;HUN;Békéscsabai AC;Békéscsaba;M;58;10 / F4;4733;10022;0;14755;0;0;0;0;0;0;0;0;0;0;0;0;14755;49.0;2012;False;59;5.0187074829931975
999.0;Lembke, Peter;1971;M3;SWE;-;Sollentuna;M;220;69 / F3;5225;11489;0;16714;6324;12681;0;19005;5814;13746;0;19560;0;0;0;0;55279;150.0;2012;False;41;6.142111111111111
999.0;Filip Krisztián;1976;M2;HUN;HASE;Balassagyarmat;M;289;58 / F2;3767;7882;0;11649;4181;8511;0;12692;0;0;0;0;0;0;0;0;24341;65.0;2012;False;36;6.2412820512820515
999.0;Juhász Péter;1970;M3;HUN;Spuri SC;Budapest;M;290;71 / F3;3764;7883;0;11647;4179;9067;0;13246;3291;7541;0;10832;4153;9468;0;13621;49346;105.0;2012;False;42;7.832698412698412
999.0;Maczó András;1949;M5;HUN;Zöldgömb SK;Budapest;M;26;9 / F4;6583;15053;0;21636;7461;15780;0;23241;0;0;0;0;7835;0;0;7835;52712;81.0;2012;False;63;10.846090534979423
999.0;Dáva Iván;1960;M4;HUN;Újbuda TC;Budaörs;M;23;66 / F3;4242;9690;0;13932;4859;11087;0;15946;0;0;0;0;0;0;0;0;29878;101.0;2012;False;52;4.93036303630363
999.0;Ács László;1960;M4;HUN;MH 86.Szolnok Helikopter Bázis-Honvéd SE;Szolnok;M;271;70 / F3;4755;10222;0;14977;5723;11828;0;17551;5028;12178;0;17206;6118;14043;0;20161;69895;174.0;2012;False;52;6.69492337164751
999.0;Csorba László;1970;M3;HUN;-;Eger;M;116;67 / F3;5215;11614;0;16829;7046;14973;0;22019;0;0;0;0;0;0;0;0;38848;102.0;2012;False;42;6.347712418300654
999.0;Cserhalmi Ágnes;1976;F2;HUN;SZUFLA;Budapest;F;282;7 / N2;5844;13692;0;19536;6884;14745;0;21629;5817;0;0;5817;6923;16139;0;23062;70044;173.0;2012;False;36;6.747976878612717
999.0;Hack Román Antal;1974;M2;HUN;Hack-i mer az nyer;Nyergesújfalu;M;25;52 / F2;5209;12139;0;17348;7215;16190;0;23405;5203;13615;0;18818;7444;17691;0;25135;84706;175.0;2012;False;38;8.067238095238094
999.0;Baranyai Máté;1978;M2;HUN;-;Balatonfüred;M;151;54 / F2;4579;11755;0;16334;5965;13996;0;19961;4998;12097;0;17095;6119;14117;0;20236;73626;175.0;2012;False;34;7.012
999.0;Wiesler, Peter;1955;M4;SWE;-;Akersberga;M;219;11 / F4;5845;12929;0;18774;7290;15719;0;23009;6029;0;0;6029;7171;17558;0;24729;72541;110.0;2012;False;57;10.991060606060605
999.0;Szita János;1973;M2;HUN;Taszári Honvéd SE;Kaposvár;M;257;56 / F2;5257;12363;0;17620;6555;13321;0;19876;5414;13048;0;18462;6561;15277;0;21838;77796;126.0;2012;False;39;10.29047619047619
999.0;Róta Annamária;1981;F2;HUN;Békéscsabai AC;Békéscsaba;F;142;6 / N2;4936;10936;0;15872;0;0;0;0;5179;12072;0;17251;5677;0;0;5677;38800;92.0;2012;False;31;7.028985507246376
999.0;Szalma Rita;1970;F3;HUN;-;Budapest;F;134;14 / N3;4781;10700;0;15481;0;0;0;0;0;0;0;0;0;0;0;0;15481;49.0;2012;False;42;5.265646258503401
999.0;Korcsmáros Tamás;1972;M3;HUN;-;Békéscsaba;M;246;55 / F2;5925;13548;0;19473;6818;13688;0;20506;0;0;0;0;0;0;0;0;39979;99.0;2012;False;40;6.730471380471381
999.0;Kozelj, Bostjan;1978;M2;SLO;-;Bled;M;265;57 / F2;5070;11148;0;16218;6161;12932;0;19093;0;0;0;0;0;0;0;0;35311;99.0;2012;False;34;5.9446127946127945
999.0;Burányi Viktor;1973;M2;HUN;Szaratov II. Klub;Budapest;M;294;59 / F2;4294;9214;0;13508;4997;10379;0;15376;0;0;0;0;0;0;0;0;28884;99.0;2012;False;39;4.862626262626263
999.0;Kirmer Tamás;1983;M2;HUN;-;Barcs;M;127;53 / F2;5405;12751;0;18156;0;0;0;0;0;0;0;0;6246;14972;0;21218;39374;101.0;2012;False;29;6.497359735973598
1.0;Grazys, Vytautas;1967;M3;LTU;-;Vilnius District;M;231;1 (F3);3523;7550;0;11073;4133;8208;0;12341;3412;7865;0;11277;4400;9203;0;13603;48294;195.0;2011;True;44;4.127692307692308
2.0;Ardzijauskas, Aidas;1971;M3;LTU;-;Vilnius;M;167;2 (F3);3523;7550;0;11073;4146;8221;0;12367;3409;7864;0;11273;4400;9202;0;13602;48315;195.0;2011;True;40;4.12948717948718
3.0;Herget, Thomas;1967;M3;GER;LG Fulda;Fulda;M;161;3 (F3);3729;8002;0;11731;4113;8216;0;12329;3453;7853;0;11306;4400;9204;0;13604;48970;195.0;2011;True;44;4.185470085470086
4.0;Juhász Péter;1970;M3;HUN;Spuri SC;Budapest;M;227;4 (F3);3445;7557;0;11002;3945;8145;0;12090;3457;8375;0;11832;4480;0;0;4480;39404;195.0;2011;True;41;3.367863247863248
5.0;Belej Bálint;1977;M2;HUN;-;Budapest;M;233;1 (F2);3644;7975;0;11619;4086;8491;0;12577;3376;8113;0;11489;4179;9291;0;13470;49155;195.0;2011;True;34;4.2012820512820515
6.0;Lajkó Csaba;1966;M3;HUN;Honvéd Szondi SE;Székesfehérvár;M;149;5 (F3);3876;8247;0;12123;4453;8909;0;13362;3698;8660;0;12358;4740;10096;0;14836;52679;195.0;2011;True;45;4.502478632478632
7.0;Rudolf Tamás;1979;M2;HUN;Kanizsai Futóklub;Becsehely;M;211;2 (F2);4093;8798;0;12891;4537;8925;0;13462;3727;8563;0;12290;4497;0;0;4497;43140;195.0;2011;True;32;3.687179487179487
8.0;Bogár János;1964;M3;HUN;Encs-Unix SE;Fancsal;M;210;6 (F3);0;7868;0;7868;4317;8649;0;12966;3631;9156;0;12787;4775;9901;0;14676;48297;195.0;2011;True;47;4.127948717948718
9.0;Herbák Gergő;1980;M2;HUN;Gróf Hadik A. HSE;Budapest;M;138;3 (F2);3673;8062;0;11735;4276;8926;0;13202;3614;8647;0;12261;4664;10136;0;14800;51998;195.0;2011;True;31;4.444273504273505
10.0;Zahorán Ádám;1986;M1;HUN;Unix TFSE;Békéscsaba;M;224;1 (F1);3442;7452;0;10894;4125;8355;0;12480;3830;9166;0;12996;5144;11170;0;16314;52684;195.0;2011;True;25;4.502905982905983
11.0;Gross, Richard;1967;M3;ITA;-;Sarntal;M;228;7 (F3);3696;8116;0;11812;4652;9369;0;14021;3808;8801;0;12609;5117;10574;0;15691;54133;195.0;2011;True;44;4.6267521367521365
12.0;Kovács Tamás;1970;M3;HUN;-;Budapest;M;143;8 (F3);3610;7895;0;11505;4396;9078;0;13474;3842;8788;0;12630;4947;10514;0;15461;53070;195.0;2011;True;41;4.535897435897436
13.0;Hönsch Viktor;1959;M4;HUN;-;Budapest;M;147;9 (F3);4014;8529;0;12543;4197;8554;0;12751;3833;8684;0;12517;4759;10124;0;14883;52694;195.0;2011;True;52;4.503760683760684
14.0;Riedel, Roland;1963;M3;GER;Adler-Langlauf Bottrop;Oberhausen;M;174;10 (F3);4295;8893;0;13188;4676;9325;0;14001;3788;8762;0;12550;4938;10455;0;15393;55132;195.0;2011;True;48;4.712136752136752
1.0;Görög Veronika;1981;F2;HUN;Keszthelyi Kilométerek;Herceghalom;F;186;1 (N2);4092;8797;0;12889;4693;9299;0;13992;3806;8767;0;12573;4944;10358;0;15302;54756;195.0;2011;True;30;4.68
2.0;Rácz Adél;1968;F3;HUN;-;Tihany;F;110;1 (N3);4184;8988;0;13172;4640;9375;0;14015;3805;8773;0;12578;5001;10715;0;15716;55481;195.0;2011;True;43;4.7419658119658115
15.0;Dobi Zsigmond;1974;M2;HUN;KEFE- Komárom;Komárom;M;104;4 (F2);3916;8515;0;12431;4548;9006;0;13554;3721;8608;0;12329;4692;10159;0;14851;53165;195.0;2011;True;37;4.544017094017094
16.0;Séra István;1960;M4;HUN;-;Budapest;M;36;11 (F3);4186;8964;0;13150;4638;9401;0;14039;3771;8739;0;12510;4999;10715;0;15714;55413;195.0;2011;True;51;4.7361538461538455
17.0;Kerekes László;1967;M3;HUN;-;Szekszárd;M;196;12 (F3);4368;9069;0;13437;4772;9457;0;14229;3944;9203;0;13147;5163;10826;0;15989;56802;195.0;2011;True;44;4.854871794871795
18.0;Vakhal Norbert;1979;M2;HUN;Honvéd Rákóczi SE;Székesfehérvár;M;203;5 (F2);4395;9191;0;13586;4840;9705;0;14545;3984;9096;0;13080;5041;10828;0;15869;57080;195.0;2011;True;32;4.878632478632479
19.0;Papp Sándor;1970;M3;HUN;Debreceni Rendőr SE;Vámospércs;M;131;13 (F3);4292;8936;0;13228;4770;9459;0;14229;4013;9300;0;13313;5163;10783;0;15946;56716;195.0;2011;True;41;4.8475213675213675
20.0;Vaczkó Zsolt;1971;M3;HUN;-;Budapest;M;114;14 (F3);4064;8660;0;12724;4672;9279;0;13951;3964;9317;0;13281;4951;10886;0;15837;55793;195.0;2011;True;40;4.768632478632479
21.0;Vadász Attila;1964;M3;HUN;Tapolca Honvéd SE;Szigliget;M;199;15 (F3);3899;8450;0;12349;4884;9525;0;14409;4038;9372;0;13410;5557;11619;0;17176;57344;195.0;2011;True;47;4.901196581196581
22.0;Simon Zoltán;1970;M3;HUN;-;Solymár;M;37;16 (F3);4367;9200;0;13567;5095;10085;0;15180;4178;9414;0;13592;5226;10983;0;16209;58548;195.0;2011;True;41;5.004102564102564
23.0;Salamon István;1962;M3;HUN;-;Mezőtárkány;M;34;17 (F3);4370;9207;0;13577;5092;9982;0;15074;4126;9427;0;13553;5225;10981;0;16206;58410;195.0;2011;True;49;4.992307692307692
24.0;Burányi Viktor;1973;M2;HUN;Szaratov II. Klub;Budapest;M;237;6 (F2);4545;9616;0;14161;5067;9951;0;15018;4049;9255;0;13304;5211;10832;0;16043;58526;195.0;2011;True;38;5.002222222222222
3.0;Bense Krisztina;1972;F2;HUN;-;Szeged;F;205;2 (N2);4095;9039;0;13134;4967;9925;0;14892;4010;9262;0;13272;5028;10882;0;15910;57208;195.0;2011;True;39;4.88957264957265
25.0;Ács László;1961;M3;HUN;Á-C-S- SC;Nagykanizsa;M;101;18 (F3);3919;8372;0;12291;4901;9912;0;14813;5245;10767;0;16012;5481;11418;0;16899;60015;195.0;2011;True;50;5.12948717948718
26.0;Pók János;1963;M3;HUN;Axiál Kft.;Gárdony (Agárd);M;33;19 (F3);4228;8968;0;13196;5116;10220;0;15336;4241;9752;0;13993;5415;11412;0;16827;59352;195.0;2011;True;48;5.072820512820513
27.0;Visnyei József;1972;M2;HUN;Pénzügyőr SE;Nagykáta;M;201;7 (F2);4755;9833;0;14588;5317;10492;0;15809;3996;0;0;3996;5079;10996;0;16075;50468;195.0;2011;True;39;4.3135042735042735
28.0;Dikó Tibor;1974;M2;HUN;-;Budapest;M;191;8 (F2);4616;9649;0;14265;5125;10172;0;15297;4302;9797;0;14099;5529;11540;0;17069;60730;195.0;2011;True;37;5.190598290598291
29.0;Sipos Sándor;1957;M4;HUN;HASE;Budapest;M;213;20 (F3);4540;9614;0;14154;5094;10105;0;15199;4202;9828;0;14030;5450;11567;0;17017;60400;195.0;2011;True;54;5.162393162393162
30.0;Szentes Zsolt;1971;M3;HUN;-;Veszprém;M;112;21 (F3);4277;9038;0;13315;4995;10046;0;15041;4350;9932;0;14282;5485;11518;0;17003;59641;195.0;2011;True;40;5.0975213675213675
4.0;Makai Viktória;1980;F2;HUN;Esztergomi Futóművek;Budapest;F;145;3 (N2);4360;9521;0;13881;5269;10686;0;15955;3977;9427;0;13404;5357;11440;0;16797;60037;195.0;2011;True;31;5.131367521367522
31.0;Pintér Sándor;1975;M2;HUN;Pénzügyőr SE;Gödöllő;M;239;9 (F2);3988;8780;0;12768;4859;9906;0;14765;4233;10389;0;14622;5038;11295;0;16333;58488;195.0;2011;True;36;4.998974358974359
32.0;Jameson, Iveagh;1970;M3;IRL;-;Bailieborough;M;193;22 (F3);5095;10463;0;15558;5016;10087;0;15103;4009;9401;0;13410;6009;12285;0;18294;62365;195.0;2011;True;41;5.330341880341881
33.0;Kiss Péter;1986;M1;HUN;Margita 344,2 TSE;Gyöngyös;M;17;2 (F1);4059;8926;0;12985;4720;9429;0;14149;4244;10185;0;14429;5210;12025;0;17235;58798;195.0;2011;True;25;5.025470085470086
5.0;Gyebnár Éva;1979;F2;HUN;Békési DAC;Békéscsaba;F;127;4 (N2);4832;10280;0;15112;5420;10678;0;16098;4341;10060;0;14401;5518;11481;0;16999;62610;195.0;2011;True;32;5.351282051282051
34.0;Tóth Csaba;1973;M2;HUN;-;Budapest;M;181;10 (F2);4750;10153;0;14903;5366;10794;0;16160;4269;9771;0;14040;5154;0;0;5154;50257;195.0;2011;True;38;4.295470085470085
35.0;Bajcsi Sándor;1956;M4;HUN;Óbudai Futókör;Üröm;M;152;23 (F3);4268;9263;0;13531;5111;10657;0;15768;4264;9878;0;14142;5389;11518;0;16907;60348;195.0;2011;True;55;5.157948717948718
6.0;Máténé Varju Edit;1971;F3;HUN;Szondi SE;Székesfehérvár;F;132;5 (N2);4758;10182;0;14940;5403;10682;0;16085;4336;10127;0;14463;5519;11605;0;17124;62612;195.0;2011;True;40;5.351452991452991
36.0;Temesi Dániel;1980;M2;HUN;BMTE Triatlon;Budapest;M;155;11 (F2);4734;10061;0;14795;5667;11350;0;17017;4348;10087;0;14435;5038;10585;0;15623;61870;195.0;2011;True;31;5.288034188034189
37.0;Klam Csaba;1970;M3;HUN;Amatőr;Soltvadkert;M;29;24 (F3);4658;9747;0;14405;5449;10761;0;16210;4301;10061;0;14362;5675;12154;0;17829;62806;195.0;2011;True;41;5.368034188034188
38.0;Révhegyi Zoltán;1971;M3;HUN;Baltazár SC;Budapest;M;189;12 (F2);4665;10156;0;14821;5390;10847;0;16237;4314;9935;0;14249;5508;11873;0;17381;62688;195.0;2011;True;40;5.357948717948718
39.0;Simonyi Balázs;1980;M2;HUN;-;Budapest;M;195;13 (F2);4903;10499;0;15402;5442;10893;0;16335;4211;9744;0;13955;5384;12008;0;17392;63084;195.0;2011;True;31;5.391794871794872
7.0;Martinák Anikó;1973;F2;HUN;-;Budapest;F;124;6 (N2);4373;9724;0;14097;5226;10558;0;15784;4341;10109;0;14450;5501;11737;0;17238;61569;195.0;2011;True;38;5.262307692307693
40.0;Bene Ferenc;1956;M4;HUN;Hirös Futó Klub;Kecskemét;M;156;25 (F3);4489;9631;0;14120;5243;10550;0;15793;4277;9991;0;14268;5913;12369;0;18282;62463;195.0;2011;True;55;5.338717948717949
41.0;Lakatos István;1961;M3;HUN;Boróka SE - Maxballoon;Kecskemét;M;144;26 (F3);4331;9325;0;13656;5133;10248;0;15381;4301;10098;0;14399;5631;12156;0;17787;61223;195.0;2011;True;50;5.232735042735043
42.0;Pehnec, David;1977;M2;SLO;-;Novo mesto;M;176;14 (F2);4655;9880;0;14535;5710;11364;0;17074;4414;10054;0;14468;5603;11805;0;17408;63485;195.0;2011;True;34;5.426068376068375
43.0;Földi Dávid;1975;M2;HUN;Spuri SC;Szentendre;M;188;15 (F2);4743;10046;0;14789;5536;11102;0;16638;4334;10045;0;14379;5471;11819;0;17290;63096;195.0;2011;True;36;5.392820512820513
44.0;Perusic, Anton;1963;M3;SLO;BUTURAJ;Ljubljana;M;208;27 (F3);4484;9771;0;14255;5273;10559;0;15832;4383;10370;0;14753;5577;12438;0;18015;62855;195.0;2011;True;48;5.372222222222222
45.0;Gilmer, Paul;1958;M4;USA;-;Budapest;M;142;28 (F3);4573;0;0;4573;5392;10977;0;16369;4557;10298;0;14855;5433;11545;0;16978;52775;195.0;2011;True;53;4.510683760683761
46.0;Billson, Simon;1976;M2;GBR;MVH Tri;Coventry;M;165;16 (F2);4213;9404;0;13617;5082;10138;0;15220;4115;9960;0;14075;5620;12850;0;18470;61382;195.0;2011;True;35;5.246324786324786
47.0;Lukovics Béla;1953;M4;HUN;Békéscsabai AC;Békéscsaba;M;58;29 (F3);4832;10279;0;15111;5421;10710;0;16131;4440;0;0;4440;5772;12334;0;18106;53788;195.0;2011;True;58;4.597264957264957
48.0;Huszty Béla;1964;M3;HUN;KELE;Kalocsa;M;209;30 (F3);4761;10275;0;15036;5702;11338;0;17040;4606;10429;0;15035;5883;12351;0;18234;65345;195.0;2011;True;47;5.585042735042735
49.0;Dingler, Andreas;1971;M3;GER;Therme LT Böblingen;Weil der Stadt;M;170;17 (F2);5136;10635;0;15771;5503;10943;0;16446;4527;10370;0;14897;5673;12001;0;17674;64788;195.0;2011;True;40;5.5374358974358975
50.0;Windisch, Ralf;1969;M3;GER;Therme LT Böblingen;Grafenau;M;169;31 (F3);5133;10638;0;15771;5506;10945;0;16451;4531;10371;0;14902;5674;12001;0;17675;64799;195.0;2011;True;42;5.538376068376069
51.0;Sándor Zoltán;1969;M3;HUN;-;Pécs;M;221;32 (F3);5011;10223;0;15234;5619;11058;0;16677;4646;10467;0;15113;6040;12743;0;18783;65807;195.0;2011;True;42;5.624529914529915
52.0;Gusztos Péter;1976;M2;HUN;Suhanj! Alapítvány;Budapest;M;117;18 (F2);4903;10497;0;15400;5448;10899;0;16347;4563;10419;0;14982;5855;12413;0;18268;64997;195.0;2011;True;35;5.555299145299145
53.0;Gedey József;1975;M2;;-;;M;251;19 (F2);0;9890;0;9890;5461;10885;0;16346;4480;10418;0;14898;5815;12605;0;18420;59554;195.0;2011;True;36;5.09008547008547
54.0;Láng István;1957;M4;HUN;Messer Futóklub;Göd (Alsógöd);M;30;33 (F3);4566;9786;0;14352;5505;11095;0;16600;4683;10616;0;15299;5967;12364;0;18331;64582;195.0;2011;True;54;5.51982905982906
55.0;Farkas László;1967;M3;HUN;Futóbolondok SE;Budapest;M;20;34 (F3);4567;9786;0;14353;5535;11117;0;16652;4699;10664;0;15363;5966;12365;0;18331;64699;195.0;2011;True;44;5.529829059829059
56.0;Pitkanen, Antti;1961;M3;FIN;-;Hyvinkaa;M;163;35 (F3);5100;10695;0;15795;5505;10923;0;16428;4594;10555;0;15149;5924;12528;0;18452;65824;195.0;2011;True;50;5.625982905982906
8.0;Zsupányi Adrienn;1985;F1;HUN;Szondi SE;Székesfehérvár;F;151;7 (N2);4865;10471;0;15336;5644;11200;0;16844;4377;10149;0;14526;5679;12211;0;17890;64596;195.0;2011;True;26;5.52102564102564
57.0;Szőke Tamás;1970;M3;HUN;Szondi SE;Székesfehérvár;M;14;36 (F3);4863;10474;0;15337;5646;11202;0;16848;4384;10158;0;14542;5682;12213;0;17895;64622;195.0;2011;True;41;5.523247863247863
9.0;Böhm Judit;1976;F2;HUN;Szondi SE;Lovasberény;F;198;8 (N2);4837;10271;0;15108;5650;11204;0;16854;4388;10140;0;14528;5921;12582;0;18503;64993;195.0;2011;True;35;5.554957264957265
58.0;Evetovics Milán;1980;M2;HUN;Futóbolondok SE;Budapest;M;217;20 (F2);4781;10043;0;14824;5315;10997;0;16312;4667;11224;0;15891;5986;12634;0;18620;65647;195.0;2011;True;31;5.6108547008547
59.0;Makkos Lóránt;1977;M2;HUN;Jászberényi Triatlon;Pécs;M;107;21 (F2);3899;8365;0;12264;4894;0;0;4894;0;11138;0;11138;6128;13665;0;19793;48089;195.0;2011;True;34;4.11017094017094
60.0;Czaltig Zsolt;1974;M2;HUN;-;Százhalombatta;M;150;22 (F2);4962;10581;0;15543;5614;11248;0;16862;4565;10657;0;15222;5742;12391;0;18133;65760;195.0;2011;True;37;5.62051282051282
61.0;Tóth Iván Csaba;1974;M2;HUN;Vasemberek Klubja;Fót;M;220;23 (F2);5020;10530;0;15550;5724;11384;0;17108;4828;11292;0;16120;6045;12601;0;18646;67424;195.0;2011;True;37;5.762735042735043
62.0;Farkas Sándor;1974;M2;HUN;Honvéd Bercsényi SE;Cegléd;M;158;24 (F2);4750;10155;0;14905;5761;11514;0;17275;4685;10910;0;15595;6235;13430;0;19665;67440;195.0;2011;True;37;5.764102564102564
63.0;Morócz József;1969;M3;HUN;-;Budapest;M;108;37 (F3);4563;9914;0;14477;5178;10704;0;15882;4469;10933;0;15402;5788;13000;0;18788;64549;195.0;2011;True;42;5.517008547008547
64.0;Szabó Balázs dr.;1970;M3;HUN;-;Budapest;M;103;38 (F3);4818;10496;0;15314;5685;11580;0;17265;4776;11220;0;15996;6361;13164;0;19525;68100;195.0;2011;True;41;5.82051282051282
65.0;Posztobányi Zoltán;1963;M3;HUN;KELE;Kalocsa;M;192;39 (F3);4759;10309;0;15068;5700;11455;0;17155;4691;11254;0;15945;5884;12677;0;18561;66729;195.0;2011;True;48;5.703333333333334
10.0;Hogan-Murphy, Diana;1977;F2;IRL;Annalee AC;Galway;F;166;9 (N2);4567;9774;0;14341;5188;10497;0;15685;4437;10653;0;15090;6482;14492;0;20974;66090;195.0;2011;True;34;5.648717948717949
66.0;Járosi Tamás;1973;M2;HUN;-;Nagykanizsa;M;215;25 (F2);4764;10176;0;14940;5218;10822;0;16040;4410;10864;0;15274;6368;13892;0;20260;66514;195.0;2011;True;38;5.684957264957265
67.0;Tigyi László;1960;M4;HUN;Nudlik SE;Budapest;M;113;40 (F3);4461;9849;0;14310;5576;11577;0;17153;4480;10716;0;15196;5775;12660;0;18435;65094;195.0;2011;True;51;5.563589743589744
68.0;Gáspár Viktor;1973;M2;HUN;CSEFUSZ;Budapest;M;126;26 (F2);5096;10688;0;15784;5895;11888;0;17783;4840;11691;0;16531;6229;13405;0;19634;69732;195.0;2011;True;38;5.96
69.0;Szénai László dr.;1966;M3;HUN;Szondi SE;Székesfehérvár;M;51;41 (F3);4856;10598;0;15454;5623;11663;0;17286;4759;11385;0;16144;6612;13795;0;20407;69291;195.0;2011;True;45;5.922307692307692
70.0;Fekete Árpád;1976;M2;HUN;-;Hódmezővásárhely;M;190;27 (F2);5317;11405;0;16722;6016;11974;0;17990;4922;11232;0;16154;6233;13177;0;19410;70276;195.0;2011;True;35;6.006495726495727
71.0;Kolonics Tamás;1971;M3;HUN;-;Váchartyán;M;106;28 (F2);4672;10196;0;14868;5576;11273;0;16849;4753;11185;0;15938;5820;12774;0;18594;66249;195.0;2011;True;40;5.662307692307693
72.0;Matlák Tamás dr.;1961;M3;HUN;Futóbolondok SE;Pomáz;M;175;42 (F3);4980;10583;0;15563;5766;11743;0;17509;4752;10857;0;15609;6503;14268;0;20771;69452;195.0;2011;True;50;5.936068376068376
73.0;Gáti Levente;1959;M4;HUN;ALLTECH;Budapest;M;122;43 (F3);5102;10680;0;15782;5895;11887;0;17782;4840;11676;0;16516;6225;13736;0;19961;70041;195.0;2011;True;52;5.986410256410256
74.0;Gyssler, Roland;1975;M2;;-;;M;252;29 (F2);5351;11162;0;16513;6130;12158;0;18288;4909;11357;0;16266;6557;13715;0;20272;71339;195.0;2011;True;36;6.0973504273504275
75.0;Szabó Attila;1969;M3;HUN;-;Budaörs;M;216;44 (F3);5027;10654;0;15681;5662;11569;0;17231;4610;10651;0;15261;6119;14097;0;20216;68389;195.0;2011;True;42;5.8452136752136745
76.0;Méreg József;1951;M5;HUN;Marathon TKE;Várpalota;M;234;45 (F3);4773;10473;0;15246;5765;11544;0;17309;4754;11291;0;16045;6214;14339;0;20553;69153;195.0;2011;True;60;5.91051282051282
77.0;Boudenot, Patrick Dr.;1954;M4;FRA;-;cellettes;M;168;46 (F3);5411;0;0;5411;5941;11926;0;17867;4803;0;0;4803;6214;13274;0;19488;47569;195.0;2011;True;57;4.065726495726496
11.0;Czégény Erzsébet;1967;F3;HUN;Elite fitt;Békéscsaba;F;202;2 (N3);4841;10493;0;15334;5784;11884;0;17668;4894;11975;0;16869;6367;13723;0;20090;69961;195.0;2011;True;44;5.979572649572649
12.0;Nixon, Rosemary;1968;F3;GBR;-;Annecy;F;164;3 (N3);4994;10724;0;15718;5642;11624;0;17266;4940;11646;0;16586;6510;14016;0;20526;70096;195.0;2011;True;43;5.991111111111111
13.0;Druskó Zsófia;1966;F3;HUN;Kanizsai Futóklub;Törökbálint;F;139;4 (N3);4759;10415;0;15174;5767;12086;0;17853;4983;11883;0;16866;6551;14386;0;20937;70830;195.0;2011;True;45;6.053846153846154
78.0;Szabó Zoltán dr;1958;M4;HUN;-;Dunaújváros;M;204;47 (F3);0;10530;0;10530;5604;11241;0;16845;4770;0;0;4770;6676;15010;0;21686;53831;195.0;2011;True;53;4.600940170940171
79.0;Vass János;1967;M3;HUN;-;Budapest;M;44;48 (F3);4568;10030;0;14598;5807;12195;0;18002;4878;11628;0;16506;6364;13709;0;20073;69179;195.0;2011;True;44;5.912735042735043
80.0;Köves Péter;1972;M2;HUN;Nagykanizsai AK;Nagykanizsa;M;235;30 (F2);5106;11172;0;16278;5216;10708;0;15924;4757;11628;0;16385;6039;13170;0;19209;67796;195.0;2011;True;39;5.794529914529915
81.0;Fazekas János;1968;M3;HUN;Szigethalmi TE;Budapest;M;137;49 (F3);5169;10679;0;15848;5941;11849;0;17790;4615;10546;0;15161;6958;15565;0;22523;71322;195.0;2011;True;43;6.095897435897436
82.0;Kollár Zoltán;1965;M3;HUN;Knorr-Bremse;Budapest;M;55;50 (F3);5262;11264;0;16526;6120;12188;0;18308;5057;0;0;5057;6384;13727;0;20111;60002;195.0;2011;True;46;5.128376068376069
14.0;Christ, Heike;1969;F3;GER;LT Sulz am Eck;Horb-Mühringen;F;154;5 (N3);5521;11564;0;17085;6250;12473;0;18723;5213;12000;0;17213;6552;13798;0;20350;73371;195.0;2011;True;42;6.27102564102564
83.0;Gaeckle, Andreas;1966;M3;GER;-;Kornwestheim;M;172;51 (F3);5520;11563;0;17083;6248;12471;0;18719;5214;12004;0;17218;6552;13799;0;20351;73371;195.0;2011;True;45;6.27102564102564
84.0;Major László dr;1963;M3;HUN;-;Székesfehérvár;M;236;52 (F3);5243;11448;0;16691;5792;11754;0;17546;4724;11415;0;16139;6442;14025;0;20467;70843;195.0;2011;True;48;6.054957264957265
85.0;Komjáti Sándor dr.;1964;M3;HUN;Tapolca Honvéd SE;Tapolca;M;219;53 (F3);4890;0;0;4890;5667;11659;0;17326;5083;0;0;5083;5975;13192;0;19167;46466;195.0;2011;True;47;3.971452991452991
86.0;Pálffy Tibor;1953;M4;HUN;Margita 344,2 TSE;Gödöllő;M;16;54 (F3);4924;0;0;4924;5638;11730;0;17368;5074;12089;0;17163;6672;14766;0;21438;60893;195.0;2011;True;58;5.204529914529915
15.0;Leckie, Victoria;1976;F2;GBR;-;Dubai;F;178;10 (N2);5124;0;0;5124;6214;12822;0;19036;0;12048;0;12048;6510;14019;0;20529;56737;195.0;2011;True;35;4.84931623931624
16.0;Marosiné Szalay Tünde;1982;F2;HUN;IKEA FC;Budapest;F;184;11 (N2);5332;11556;0;16888;6130;12434;0;18564;5356;12598;0;17954;6705;14250;0;20955;74361;195.0;2011;True;29;6.355641025641025
87.0;Marosi Péter;1975;M2;HUN;IKEA FC;Baja;M;185;31 (F2);5332;11557;0;16889;6132;12439;0;18571;5354;12597;0;17951;6706;14252;0;20958;74369;195.0;2011;True;36;6.3563247863247865
88.0;Márton Attila;1956;M4;HUN;Honvéd;Érd;M;157;55 (F3);5072;11456;0;16528;5959;11790;0;17749;5135;11823;0;16958;6580;14119;0;20699;71934;195.0;2011;True;55;6.148205128205129
89.0;Gerencsér Miklós;1977;M2;HUN;-;Budapest;M;182;32 (F2);5013;11372;0;16385;5955;12326;0;18281;4777;11619;0;16396;7063;15407;0;22470;73532;195.0;2011;True;34;6.2847863247863245
90.0;Dáva Iván;1960;M4;HUN;-;Budaörs;M;23;56 (F3);4707;10696;0;15403;5678;12295;0;17973;4818;12103;0;16921;6628;14712;0;21340;71637;195.0;2011;True;51;6.122820512820513
91.0;Ocelka Róbert;1974;M2;HUN;Lőrincz DSE;Cegléd;M;226;33 (F2);4704;10693;0;15397;5677;12298;0;17975;4815;12107;0;16922;6620;14709;0;21329;71623;195.0;2011;True;37;6.121623931623931
17.0;Szalma Rita;1970;F3;HUN;-;Budapest;F;134;6 (N3);5193;11261;0;16454;6182;12559;0;18741;5205;12503;0;17708;6586;14374;0;20960;73863;195.0;2011;True;41;6.313076923076923
92.0;Simon Péter;1965;M3;HUN;-;Budapest;M;133;57 (F3);5191;11261;0;16452;6180;12557;0;18737;5249;12506;0;17755;6587;14379;0;20966;73910;195.0;2011;True;46;6.317094017094017
93.0;Marx Norbert;1973;M2;HUN;-;Tata;M;130;34 (F2);5071;11392;0;16463;6223;12676;0;18899;5115;12234;0;17349;6645;14505;0;21150;73861;195.0;2011;True;38;6.312905982905983
94.0;Bakos Gábor;1966;M3;HUN;-;Dunakeszi;M;162;58 (F3);4814;10272;0;15086;5868;12812;0;18680;5010;12354;0;17364;6888;15490;0;22378;73508;195.0;2011;True;45;6.282735042735044
18.0;Berzy Judith;1973;F2;HUN;-;Budapest;F;22;12 (N2);5209;11643;0;16852;6005;12589;0;18594;5240;12572;0;17812;6410;14054;0;20464;73722;195.0;2011;True;38;6.3010256410256416
95.0;Erdei, Ferencz;1975;M2;ROM;-;Szatmárnémeti;M;153;35 (F2);5967;12993;0;18960;6002;12215;0;18217;4676;11008;0;15684;7021;15653;0;22674;75535;195.0;2011;True;36;6.455982905982906
96.0;Szedlák Bálint;1983;M2;HUN;-;Dunaharaszti;M;120;36 (F2);5034;10906;0;15940;6044;12350;0;18394;5353;13190;0;18543;7470;17148;0;24618;77495;195.0;2011;True;28;6.623504273504273
97.0;Gabányi Balázs;1976;M2;HUN;UniCredit Futókör;Göd;M;160;37 (F2);5033;11744;0;16777;6030;14704;0;20734;4872;11585;0;16457;5954;13009;0;18963;72931;195.0;2011;True;35;6.233418803418803
98.0;Budenszki Péter;1973;M2;HUN;MAC;Budapest;M;177;38 (F2);5214;11646;0;16860;6296;13014;0;19310;5264;12389;0;17653;6634;14476;0;21110;74933;195.0;2011;True;38;6.404529914529915
99.0;Jánosi Kornél dr;1964;M3;HUN;Buda Fitness;Szentendre;M;212;59 (F3);5092;10890;0;15982;6246;12948;0;19194;5640;13401;0;19041;6979;15508;0;22487;76704;195.0;2011;True;47;6.555897435897436
100.0;Parányi Gábor;1972;M2;HUN;-;Budapest;M;123;39 (F2);5355;11716;0;17071;6338;13408;0;19746;4932;11426;0;16358;6861;14961;0;21822;74997;195.0;2011;True;39;6.41
101.0;Bicskei Ferenc;1966;M3;HUN;-;Budapest;M;229;60 (F3);5516;11791;0;17307;6467;13589;0;20056;5608;13404;0;19012;6978;15905;0;22883;79258;195.0;2011;True;45;6.774188034188034
102.0;Balogh Ádám;1979;M2;HUN;BKV Előre SC;Budapest;M;148;40 (F2);5347;11878;0;17225;6101;13218;0;19319;4818;12125;0;16943;6611;14438;0;21049;74536;195.0;2011;True;32;6.3705982905982905
103.0;Kyrillidis, Vasileios;1958;M4;GRE;-;kavala;M;173;61 (F3);5477;11983;0;17460;6592;13185;0;19777;5628;13243;0;18871;7774;17013;0;24787;80895;195.0;2011;True;53;6.914102564102564
19.0;Fáczán Györgyi;1977;F2;HUN;-;Ravazd;F;125;13 (N2);5512;11921;0;17433;6397;13272;0;19669;5516;13194;0;18710;6776;14899;0;21675;77487;195.0;2011;True;34;6.622820512820513
20.0;Moróz Szilvia;1976;F2;HUN;-;Cegléd;F;140;14 (N2);5418;11879;0;17297;6582;13175;0;19757;5629;13238;0;18867;7774;17012;0;24786;80707;195.0;2011;True;35;6.898034188034187
104.0;Ajkay Antal;1950;M5;HUN;Sárvár Kinizsi SE;Budapest;M;102;62 (F3);5478;11962;0;17440;6688;14394;0;21082;5707;0;0;5707;7324;16365;0;23689;67918;195.0;2011;True;61;5.804957264957265
105.0;Nyerges, Jeno;1943;M5;USA;-;Sparta;M;225;63 (F3);5960;12991;0;18951;6787;13595;0;20382;6140;14171;0;20311;7706;16192;0;23898;83542;195.0;2011;True;68;7.14034188034188
106.0;Hack Román Antal;1974;M2;HUN;Hack-i mer az nyer;Nyergesújfalu;M;25;41 (F2);5206;12699;0;17905;7002;14778;0;21780;5640;13988;0;19628;7823;17121;0;24944;84257;195.0;2011;True;37;7.2014529914529914
107.0;Maczó András;1949;M5;HUN;Zöldgömb SK;Budapest;M;26;64 (F3);6052;13618;0;19670;7103;15469;0;22572;5905;14699;0;20604;7377;16441;0;23818;86664;195.0;2011;True;62;7.407179487179488
999.0;Kopecsni, Roland;1980;M2;SVK;-;Dunaszerdahely;M;180;(F2);5513;11921;0;17434;6972;14473;0;21445;0;0;0;0;0;0;0;0;38879;99.0;2011;False;31;6.545286195286195
999.0;Szabó Krisztina dr.;1971;F3;HUN;-;Budapest;F;135;(N2);5107;10927;0;16034;5620;11725;0;17345;0;0;0;0;0;0;0;0;33379;99.0;2011;False;40;5.6193602693602696
999.0;Modan, Marian;1976;M2;ROM;-;;M;256;(F2);0;0;0;0;6593;14992;0;21585;0;0;0;0;0;0;0;0;21585;49.0;2011;False;35;7.341836734693878
999.0;Van Der Pluym, Herman;1974;M2;NED;-;Arnhem;M;207;(F2);4919;11373;0;16292;0;0;0;0;0;0;0;0;0;0;0;0;16292;50.0;2011;False;37;5.430666666666667
999.0;Ádám Zsolt;1983;M2;HUN;-;Kiskunhalas;M;159;(F2);5103;10911;0;16014;6364;13396;0;19760;0;0;0;0;0;0;0;0;35774;99.0;2011;False;28;6.022558922558923
999.0;Rumi Mihály Róbert;1974;M2;HUN;Sunderland Strollers;Gárdony;M;9;(F2);4226;8802;0;13028;5112;10217;0;15329;0;0;0;0;0;0;0;0;28357;99.0;2011;False;37;4.773905723905724
999.0;Kiss Gábor Gyula;1979;M2;HUN;-;Esztergom;M;129;(F2);4822;11009;0;15831;0;0;0;0;0;0;0;0;0;0;0;0;15831;49.0;2011;False;32;5.384693877551021
999.0;Kreszta Zoltán;1970;M3;HUN;-;Budapest;M;11;(F3);4323;10033;0;14356;0;0;0;0;4398;10186;0;14584;5802;12412;0;18214;47154;152.0;2011;False;41;5.1703947368421055
999.0;Lőrincz András;1969;M3;HUN;-;Szentendre;M;118;(F3);5167;10950;0;16117;6247;12951;0;19198;5644;13406;0;19050;0;0;0;0;54365;150.0;2011;False;42;6.040555555555556
999.0;Viktor Csaba;1969;M3;HUN;BVSE;Budapest;M;230;(F3);4873;10325;0;15198;6545;13362;0;19907;0;0;0;0;6013;12476;0;18489;53594;148.0;2011;False;42;6.03536036036036
999.0;Csorba László;1970;M3;HUN;-;Eger;M;119;(F3);5150;11503;0;16653;7113;15087;0;22200;0;0;0;0;0;0;0;0;38853;99.0;2011;False;41;6.54090909090909
999.0;Gömöri, József;1964;M3;SRB;-;Magyarkanizsa;M;187;(F3);4291;9004;0;13295;5035;10178;0;15213;0;0;0;0;0;0;0;0;28508;99.0;2011;False;47;4.7993265993266
999.0;Rostás Pál;1961;M3;HUN;Napraforgó Futóklub;Hódmezővásárhely;M;206;(F3);3523;7550;0;11073;4303;8614;0;12917;0;0;0;0;0;0;0;0;23990;99.0;2011;False;50;4.038720538720539
999.0;Nedeczky László Tamás;1984;M1;HUN;-;Budapest;M;200;(F2);5142;11250;0;16392;5955;12375;0;18330;0;0;0;0;6584;14088;0;20672;55394;148.0;2011;False;27;6.238063063063064
999.0;Baranyai Máté;1978;M2;HUN;-;Várpalota;M;238;(F2);4379;10583;0;14962;0;0;0;0;0;0;0;0;0;0;0;0;14962;49.0;2011;False;33;5.089115646258503
999.0;Hack Zsanett;1984;F1;HUN;-;Nyergesújfalu;F;27;(N2);5211;12054;0;17265;0;0;0;0;5222;12162;0;17384;7537;16462;0;23999;58648;150.0;2011;False;27;6.516444444444445
999.0;Makai László;1974;M2;HUN;Esztergomi Futóművek;Budapest;M;146;(F2);4290;8983;0;13273;4841;9708;0;14549;0;0;0;0;0;0;0;0;27822;99.0;2011;False;37;4.683838383838384
999.0;Filip Krisztián;1976;M2;HUN;MATASZ Székesfehérvár;Balassagyarmat;M;57;(F2);3446;8152;0;11598;0;0;0;0;0;0;0;0;0;0;0;0;11598;49.0;2011;False;35;3.944897959183674
999.0;Nádasdi Zsolt;1978;M2;HUN;Szondi SE;Székesfehérvár;M;222;(F2);4859;10596;0;15455;5609;11257;0;16866;5004;11738;0;16742;0;0;0;0;49063;150.0;2011;False;33;5.451444444444444
999.0;Sipos Balázs;1978;M2;HUN;TTT-HSE;Budapest;M;214;(F2);3845;8069;0;11914;4468;8876;0;13344;3864;9560;0;13424;0;0;0;0;38682;150.0;2011;False;33;4.298
999.0;Gulyás Krisztina;1973;F2;HUN;Nike Futóklub - Győr;Győr;F;232;(N2);3730;8246;0;11976;4574;9304;0;13878;4852;13436;0;18288;0;0;0;0;44142;150.0;2011;False;38;4.904666666666667
1.0;Rostás Pál;1961;M3;HUN;Napraforgó Futóklub;Hódmezővásárhely;M;153;F3/1;3538;7610;0;11148;4299;8562;0;12861;3423;7923;0;11346;4481;9446;0;13927;49282;195.0;2010;True;49;4.212136752136752
2.0;Filip Krisztián;1976;M2;HUN;MATASZ Székesfehérvár;Budapest;M;57;F2/1;3606;7677;0;11283;4289;8554;0;12843;3424;7918;0;11342;4478;9412;0;13890;49358;195.0;2010;True;34;4.218632478632479
3.0;Ardzijauskas, Aidas;1971;M2;LTU;-;Vilnius;M;167;F2/2;4234;8915;0;13149;4683;9231;0;13914;3829;8505;0;12334;4504;9351;0;13855;53252;195.0;2010;True;39;4.551452991452991
4.0;Grazys, Vytautas;1967;M3;LTU;-;Vilnius District;M;165;F3/2;4236;8917;0;13153;4680;9228;0;13908;3827;8506;0;12333;4505;9350;0;13855;53249;195.0;2010;True;43;4.5511965811965815
5.0;Ács László;1961;M3;HUN;Á-C-S- SC;Nagykanizsa;M;204;F3/3;4142;8564;0;12706;4728;9280;0;14008;3888;8687;0;12575;4913;10462;0;15375;54664;195.0;2010;True;49;4.672136752136752
6.0;Kiss Sándor;1965;M3;HUN;Pécsi Futóklub;Görcsöny;M;224;F3/4;3972;8504;0;12476;4680;9380;0;14060;3749;8517;0;12266;4866;10467;0;15333;54135;195.0;2010;True;45;4.626923076923077
7.0;Baranyai Krisztián;1975;M2;HUN;Pegazusok;Törtel;M;61;F2/3;3801;8155;0;11956;4464;9083;0;13547;3855;8854;0;12709;5231;10852;0;16083;54295;195.0;2010;True;35;4.64059829059829
8.0;Herbák Gergő;1980;M2;HUN;-;Budapest;M;217;F2/4;3829;8355;0;12184;4554;9463;0;14017;3763;8839;0;12602;4769;9996;0;14765;53568;195.0;2010;True;30;4.578461538461538
1.0;Marótiné Bense Krisztina;1972;F2;HUN;Napraforgó Futóklub;Szeged;F;226;N2/1;4022;8792;0;12814;4622;9345;0;13967;3925;8969;0;12894;4869;10518;0;15387;55062;195.0;2010;True;38;4.706153846153846
9.0;Szűcsi László;1962;M3;HUN;MÁTRA SE;Gyöngyös;M;203;F3/5;3966;8569;0;12535;4882;9619;0;14501;3916;9088;0;13004;5073;10768;0;15841;55881;195.0;2010;True;48;4.776153846153846
10.0;Kerényi Farkas;1977;M2;HUN;Kanizsai Futóklub;Budapest;M;157;F2/5;4104;8748;0;12852;4710;9479;0;14189;3774;8654;0;12428;5071;10850;0;15921;55390;195.0;2010;True;33;4.734188034188034
2.0;Görög Veronika;1981;F2;HUN;Keszthelyi Kilométerek;Keszthely;F;187;N2/2;4234;8963;0;13197;5054;10016;0;15070;4078;9185;0;13263;5166;10593;0;15759;57289;195.0;2010;True;29;4.8964957264957265
11.0;Szőke Tamás;1970;M3;HUN;Szondi SE;Székesfehérvár;M;14;F2/6;4078;8772;0;12850;4840;9547;0;14387;3874;9047;0;12921;5071;10767;0;15838;55996;195.0;2010;True;40;4.785982905982906
12.0;Wallesch, René;1972;M2;GER;100 Marathon Club;Geesthacht;M;141;F2/7;4055;8758;0;12813;4705;9520;0;14225;3798;8754;0;12552;5061;11064;0;16125;55715;195.0;2010;True;38;4.761965811965812
13.0;Pintér Sándor;1975;M2;HUN;Pénzügyőr SE;Gödöllő;M;125;F2/8;4190;0;0;4190;4695;9539;0;14234;4140;9686;0;13826;4813;10524;0;15337;47587;195.0;2010;True;35;4.067264957264958
14.0;Simon Zoltán;1970;M3;HUN;-;Solymár;M;37;F2/9;4232;8965;0;13197;5002;9965;0;14967;4099;9226;0;13325;5204;10886;0;16090;57579;195.0;2010;True;40;4.921282051282051
15.0;Vakhal Norbert;1979;M2;HUN;Honvéd Rákóczi SE;Székesfehérvár;M;108;F2/10;4324;9174;0;13498;4846;9552;0;14398;3895;9058;0;12953;0;10765;0;10765;51614;195.0;2010;True;31;4.411452991452991
16.0;Kerekes László;1967;M3;HUN;-;Szekszárd;M;219;F3/6;4428;9205;0;13633;5251;10460;0;15711;4040;0;0;4040;5214;10975;0;16189;49573;195.0;2010;True;43;4.237008547008547
17.0;Szénai László dr.;1966;M3;HUN;Szondi SE;Székesfehérvár;M;51;F3/7;4097;8812;0;12909;5033;10025;0;15058;3813;8932;0;12745;5227;11522;0;16749;57461;195.0;2010;True;44;4.911196581196581
18.0;Salamon István;1962;M3;HUN;-;Mezőtárkány;M;34;F3/8;4242;9053;0;13295;4963;10135;0;15098;4069;9198;0;13267;5207;10906;0;16113;57773;195.0;2010;True;48;4.937863247863248
19.0;Papp Sándor;1970;M3;HUN;Debreceni Rendőr SE;Vámospércs;M;120;F3/9;4338;9245;0;13583;5229;10419;0;15648;4025;0;0;4025;5214;10972;0;16186;49442;195.0;2010;True;40;4.225811965811966
20.0;Vaczkó Zsolt;1971;M2;HUN;-;Budapest;M;110;F2/11;4230;8963;0;13193;4815;9549;0;14364;3885;9107;0;12992;5170;11318;0;16488;57037;195.0;2010;True;39;4.874957264957265
21.0;Rumi Mihály Róbert;1974;M2;HUN;Sunderland Strollers;Gárdony;M;9;F2/12;4439;9608;0;14047;5314;10582;0;15896;4128;9279;0;13407;5236;10911;0;16147;59497;195.0;2010;True;36;5.085213675213676
3.0;Makai Viktória;1980;F2;HUN;-;Budapest;F;119;N2/3;4288;9275;0;13563;5145;10452;0;15597;3821;8883;0;12704;5174;11182;0;16356;58220;195.0;2010;True;30;4.976068376068376
22.0;Farkas László;1967;M3;HUN;Futóbolondok SE;Veresegyház;M;20;F3/10;4224;8965;0;13189;5071;10116;0;15187;4098;9538;0;13636;5478;11502;0;16980;58992;195.0;2010;True;43;5.042051282051283
23.0;Makai László;1974;M2;HUN;-;Budapest;M;118;F2/13;4288;9246;0;13534;5146;10455;0;15601;3821;9010;0;12831;5178;11360;0;16538;58504;195.0;2010;True;36;5.000341880341881
4.0;Rácz Adél;1968;F3;HUN;-;Tihany;F;207;N3/1;4641;9876;0;14517;5353;10565;0;15918;4158;9459;0;13617;5384;11140;0;16524;60576;195.0;2010;True;42;5.177435897435897
24.0;Séra István;1960;M3;HUN;-;Budapest;M;36;F3/11;4642;9876;0;14518;5357;10568;0;15925;4158;9457;0;13615;5387;11141;0;16528;60586;195.0;2010;True;50;5.178290598290598
25.0;Reicher Norbert;1976;M2;HUN;-;Budapest;M;212;F2/14;4644;9877;0;14521;5355;10564;0;15919;4160;9460;0;13620;5455;11558;0;17013;61073;195.0;2010;True;34;5.21991452991453
5.0;Máténé Varju Edit;1971;F2;HUN;Szondi SE;Székesfehérvár;F;122;N2/4;4569;9871;0;14440;5334;10571;0;15905;4153;9527;0;13680;5453;11558;0;17011;61036;195.0;2010;True;39;5.216752136752136
26.0;Silkin, Piotr;1941;M5;LTU;-;Kretinga;M;149;F3/12;4619;9895;0;14514;5473;10817;0;16290;4223;9555;0;13778;5249;11098;0;16347;60929;195.0;2010;True;69;5.207606837606837
27.0;Láng István;1957;M4;HUN;Messer Futóklub;Göd (Alsógöd);M;30;F3/13;4232;9033;0;13265;5254;10664;0;15918;4095;9626;0;13721;5464;11505;0;16969;59873;195.0;2010;True;53;5.117350427350427
28.0;Sipos Sándor;1957;M4;HUN;HASE;Budapest;M;113;F3/14;4655;9913;0;14568;5291;10590;0;15881;4213;9828;0;14041;5545;11647;0;17192;61682;195.0;2010;True;53;5.271965811965812
6.0;Halász Gyöngyi;1978;F2;HUN;-;Budapest;F;106;N2/5;4662;9919;0;14581;5292;10540;0;15832;4191;9804;0;13995;5547;11647;0;17194;61602;195.0;2010;True;32;5.265128205128206
29.0;Szabó Béla;1963;M3;HUN;-;Keszthely;M;40;F3/15;4238;9321;0;13559;5152;10366;0;15518;4095;9631;0;13726;5460;11815;0;17275;60078;195.0;2010;True;47;5.134871794871795
30.0;Czoske, Jörg;1959;M4;GER;-;Holldorf;M;142;F3/16;4587;9858;0;14445;5368;10605;0;15973;4280;9730;0;14010;5690;11766;0;17456;61884;195.0;2010;True;51;5.28923076923077
31.0;Domán Gábor;1960;M3;HUN;Tapolca Honvéd SE;Tapolca;M;56;F3/17;3966;8640;0;12606;4751;9704;0;14455;3930;9564;0;13494;5196;12869;0;18065;58620;195.0;2010;True;50;5.01025641025641
32.0;Szentes Zsolt;1971;M2;HUN;-;Veszprém;M;195;F2/15;4582;9864;0;14446;5435;10766;0;16201;4441;10194;0;14635;5699;11860;0;17559;62841;195.0;2010;True;39;5.371025641025641
33.0;Farkas Tibor;1961;M3;HUN;T-Online;Budapest;M;222;F3/18;4100;8872;0;12972;5138;10386;0;15524;4207;9873;0;14080;5497;12060;0;17557;60133;195.0;2010;True;49;5.13957264957265
34.0;Pók János;1963;M3;HUN;Axiál Kft.;Gárdony (Agárd);M;33;F3/19;4575;9575;0;14150;5385;10648;0;16033;4564;10716;0;15280;5871;12427;0;18298;63761;195.0;2010;True;47;5.44965811965812
35.0;Jónás Gyula;1976;M2;HUN;-;Budapest;M;235;F2/16;5158;10772;0;15930;5699;11928;0;17627;5667;0;0;5667;6154;12412;0;18566;57790;195.0;2010;True;34;4.9393162393162395
36.0;Knop, Andreas;1961;M3;GER;-;Berlin;M;138;F3/20;4999;10443;0;15442;5488;10860;0;16348;4627;10424;0;15051;6264;12868;0;19132;65973;195.0;2010;True;49;5.638717948717948
37.0;Kiss Péter;1986;M1;HUN;Margita 344,2 TSE;Gyöngyös;M;17;F1/1;4106;8845;0;12951;5102;10657;0;15759;4161;9893;0;14054;5501;12443;0;17944;60708;195.0;2010;True;24;5.188717948717948
38.0;Czaltig Zsolt;1974;M2;HUN;-;Százhalombatta;M;129;F2/17;4572;9796;0;14368;5320;10776;0;16096;4455;10577;0;15032;5843;12379;0;18222;63718;195.0;2010;True;36;5.445982905982906
39.0;Kreszta Zoltán;1970;M3;HUN;-;Budapest;M;11;F2/18;4217;8971;0;13188;5136;10500;0;15636;4303;10053;0;14356;5790;12001;0;17791;60971;195.0;2010;True;40;5.211196581196581
40.0;Stossberger, Udo;1963;M3;GER;-;Calw-Stammheim;M;197;F3/21;4476;9518;0;13994;5067;10323;0;15390;4269;10790;0;15059;5689;12169;0;17858;62301;195.0;2010;True;47;5.324871794871794
41.0;Szarvas Mátyás;1961;M3;HUN;-;Békéscsaba;M;234;F3/22;4388;9383;0;13771;5244;10825;0;16069;0;10221;0;10221;5847;12382;0;18229;58290;195.0;2010;True;49;4.982051282051282
42.0;Szabó Balázs dr.;1970;M3;HUN;-;Budapest;M;103;F2/19;4877;10340;0;15217;5573;11165;0;16738;4552;10524;0;15076;5869;12357;0;18226;65257;195.0;2010;True;40;5.577521367521367
7.0;Gyebnár Éva;1979;F2;HUN;Békési DAC;Békéscsaba;F;154;N2/6;5073;10706;0;15779;5793;11474;0;17267;4547;10567;0;15114;5831;12423;0;18254;66414;195.0;2010;True;31;5.676410256410257
43.0;Ajkay Zoltán;1977;M2;HUN;-;Budapest;M;182;F2/20;4782;10171;0;14953;5746;11430;0;17176;4550;10569;0;15119;5835;12425;0;18260;65508;195.0;2010;True;33;5.598974358974359
44.0;Burányi Viktor;1973;M2;HUN;-;Budapest;M;232;F2/21;4786;10377;0;15163;5483;11097;0;16580;5313;12359;0;17672;6180;12782;0;18962;68377;195.0;2010;True;37;5.844188034188034
45.0;Linczmayer Attila;1976;M2;HUN;-;Budapest;M;208;F2/22;4228;9064;0;13292;5377;11337;0;16714;4379;10316;0;14695;5665;12300;0;17965;62666;195.0;2010;True;34;5.356068376068376
46.0;Visy Ferenc;1947;M5;HUN;Sirály;Nagykovácsi;M;201;F3/23;4403;9618;0;14021;5036;10372;0;15408;4360;10324;0;14684;5577;12297;0;17874;61987;195.0;2010;True;63;5.298034188034188
47.0;Jensen, Kim;1959;M4;DEN;-;Holstebro;M;144;F3/24;4533;9917;0;14450;5557;11498;0;17055;4299;10205;0;14504;5444;12121;0;17565;63574;195.0;2010;True;51;5.4336752136752136
8.0;Katonáné Simon Veronika;1980;F2;HUN;-;Siófok;F;128;N2/7;4856;10405;0;15261;5529;11036;0;16565;4553;10562;0;15115;5901;12821;0;18722;65663;195.0;2010;True;30;5.612222222222223
48.0;Matlák Tamás;1961;M3;HUN;Futóbolondok SE;Pomáz;M;190;F3/25;5032;10443;0;15475;5927;11949;0;17876;4657;10540;0;15197;6752;13559;0;20311;68859;195.0;2010;True;49;5.885384615384615
49.0;Fazekas János;1968;M3;HUN;Szigethalmi TE;Budapest;M;184;F3/26;5560;11969;0;17529;6367;12590;0;18957;4146;9437;0;13583;6513;12558;0;19071;69140;195.0;2010;True;42;5.909401709401709
50.0;Evetovics Milán;1980;M2;HUN;Futóbolondok SE;Budapest;M;174;F2/23;0;0;0;0;5805;11794;0;17599;4397;10258;0;14655;6081;12681;0;18762;51016;195.0;2010;True;30;4.36034188034188
51.0;Dudás Zsolt;1968;M3;HUN;-;Soltvadkert;M;205;F3/27;4437;9243;0;13680;5618;11577;0;17195;4490;10823;0;15313;5990;12945;0;18935;65123;195.0;2010;True;42;5.566068376068377
52.0;Vakhal György;1955;M4;HUN;Honvéd Rákóczi SE;Szentes;M;105;F3/28;4325;9332;0;13657;5014;10621;0;15635;4391;10759;0;15150;5475;12133;0;17608;62050;195.0;2010;True;55;5.303418803418804
53.0;Fodor Gábor;1983;M1;HUN;Pénzügyőr SE;Celldömölk;M;124;F2/24;4647;10004;0;14651;5408;11064;0;16472;4631;10935;0;15566;6240;13389;0;19629;66318;195.0;2010;True;27;5.668205128205128
54.0;Holczer Zoltán;1974;M2;HUN;Spuri SC;Tárnok;M;116;F2/25;4287;10197;0;14484;5436;11251;0;16687;4396;10453;0;14849;5542;12377;0;17919;63939;195.0;2010;True;36;5.4648717948717955
55.0;Klam Csaba;1970;M3;HUN;-;Soltvadkert;M;29;F2/26;4853;10319;0;15172;5765;11764;0;17529;4373;10253;0;14626;5992;12945;0;18937;66264;195.0;2010;True;40;5.663589743589744
56.0;Ömböly Attila;1959;M4;HUN;Szent-Györgyi Maraton;Budapest;M;191;F3/29;5343;11362;0;16705;6110;12300;0;18410;4798;11020;0;15818;5706;11921;0;17627;68560;195.0;2010;True;51;5.85982905982906
57.0;Lukovics Béla;1953;M4;HUN;Békéscsabai AC;Békéscsaba;M;58;F3/30;4945;10588;0;15533;5753;11439;0;17192;4787;11385;0;16172;5841;12750;0;18591;67488;195.0;2010;True;57;5.768205128205128
58.0;Pitkanen, Antti;1961;M3;FIN;-;Hyvinkaa;M;136;F3/31;4777;10077;0;14854;5304;10863;0;16167;4929;11656;0;16585;6659;13991;0;20650;68256;195.0;2010;True;49;5.833846153846153
59.0;Crowley, Tim;1976;M2;IRL;-;Cork;M;198;F2/27;4665;9987;0;14652;5474;10988;0;16462;4631;10913;0;15544;6125;13317;0;19442;66100;195.0;2010;True;34;5.64957264957265
60.0;Módra György;1980;M2;HUN;-;Veszprém;M;213;F2/28;4235;9914;0;14149;5265;10722;0;15987;4755;11378;0;16133;6469;13938;0;20407;66676;195.0;2010;True;30;5.6988034188034185
61.0;Jánosi Kornél dr.;1964;M3;HUN;Buda Fitness;Szentendre;M;114;F3/32;5144;10856;0;16000;5825;11906;0;17731;4799;11056;0;15855;6466;13906;0;20372;69958;195.0;2010;True;46;5.97931623931624
62.0;Mezőlaki Erik dr.;1966;M3;HUN;-;Domaszék;M;210;F3/33;4811;10184;0;14995;5893;12004;0;17897;4798;11240;0;16038;6169;13161;0;19330;68260;195.0;2010;True;44;5.834188034188035
9.0;Christ, Heike;1969;F3;GER;LT Sulz am Eck;Horb-Mühringen;F;196;N3/2;5698;12050;0;17748;6306;12438;0;18744;5127;11484;0;16611;6267;12868;0;19135;72238;195.0;2010;True;41;6.174188034188035
63.0;Declan, Donnelly;1966;M3;IRL;-;Celbridge;M;140;F3/34;4531;9835;0;14366;5889;11386;0;17275;4173;9469;0;13642;6204;13879;0;20083;65366;195.0;2010;True;44;5.586837606837607
64.0;Gáti Levente;1959;M4;HUN;-;Budapest;M;186;F3/35;5489;11662;0;17151;6175;12247;0;18422;4811;11019;0;15830;6162;12771;0;18933;70336;195.0;2010;True;51;6.011623931623932
65.0;Kollár Zoltán;1965;M3;HUN;Knorr-Bremse;Budapest;M;55;F3/36;5178;11238;0;16416;6146;12546;0;18692;4925;11404;0;16329;6148;12787;0;18935;70372;195.0;2010;True;45;6.0147008547008545
66.0;Durst János dr.;1967;M3;HUN;-;Szentendre;M;12;F3/37;5525;12021;0;17546;6075;12448;0;18523;4957;11293;0;16250;6122;12952;0;19074;71393;195.0;2010;True;43;6.101965811965813
67.0;Gáspár Viktor;1973;M2;HUN;CSEFUSZ;Budapest;M;185;F2/29;5475;11729;0;17204;6170;12636;0;18806;4775;10981;0;15756;6165;12774;0;18939;70705;195.0;2010;True;37;6.043162393162394
68.0;Vass János;1967;M3;HUN;-;Budapest;M;199;F3/38;4658;9982;0;14640;5592;11641;0;17233;4713;11539;0;16252;6340;14232;0;20572;68697;195.0;2010;True;43;5.871538461538462
69.0;Kolonics Tamás;1971;M2;HUN;-;Váchartyán;M;189;F2/30;0;0;0;0;6154;12554;0;18708;4898;11378;0;16276;6150;12587;0;18737;53721;195.0;2010;True;39;4.591538461538462
70.0;Borbély Imre;1955;M4;HUN;-;Bordány;M;214;F3/39;6015;12303;0;18318;6628;12958;0;19586;4951;11248;0;16199;6748;13834;0;20582;74685;195.0;2010;True;55;6.383333333333334
10.0;Marx, Inge;1954;F4;DEN;-;Holstebro;F;145;N3/3;5068;11182;0;16250;5747;11844;0;17591;4783;11500;0;16283;6073;13583;0;19656;69780;195.0;2010;True;56;5.964102564102564
71.0;Ács László;1960;M3;HUN;Szolnoki HSE;Szolnok;M;104;F3/40;5200;10861;0;16061;6109;12303;0;18412;5096;11823;0;16919;6507;13801;0;20308;71700;195.0;2010;True;50;6.128205128205129
72.0;Morócz József;1969;M3;HUN;-;Budapest;M;107;F3/41;5067;10706;0;15773;5660;12131;0;17791;4832;12419;0;17251;5812;12112;0;17924;68739;195.0;2010;True;41;5.875128205128205
11.0;Szabó Krisztina dr.;1971;F2;HUN;-;Érd;F;194;N2/8;5007;10980;0;15987;6106;12780;0;18886;4748;11694;0;16442;6408;14361;0;20769;72084;195.0;2010;True;39;6.161025641025642
73.0;Haywood, Brent;1965;M3;NZL;-;Falkirk;M;148;F3/42;4650;0;0;4650;5281;10974;0;16255;4809;12112;0;16921;6458;14920;0;21378;59204;195.0;2010;True;45;5.0601709401709405
12.0;Andrássy Ágnes;1980;F2;HUN;-;Budapest;F;231;N2/9;5110;11096;0;16206;6145;12398;0;18543;4645;10416;0;15061;6432;13857;0;20289;70099;195.0;2010;True;30;5.991367521367521
74.0;Perecz Attila;1979;M2;HUN;-;Budapest;M;216;F2/31;5288;11302;0;16590;6378;12815;0;19193;5363;12362;0;17725;6825;14577;0;21402;74910;195.0;2010;True;31;6.402564102564103
75.0;Soós Péter;1970;M3;HUN;Szondi SE;Székesfehérvár;M;39;F2/32;4644;10478;0;15122;5556;12026;0;17582;4691;11234;0;15925;6444;13956;0;20400;69029;195.0;2010;True;40;5.89991452991453
76.0;Dáva Iván;1960;M3;HUN;-;Budaörs;M;23;F3/43;4650;10172;0;14822;6010;12405;0;18415;5357;12026;0;17383;6699;13164;0;19863;70483;195.0;2010;True;50;6.024188034188034
13.0;Schelhorn, Claudia;1967;F3;GER;-;Berlin;F;137;N3/4;5759;12166;0;17925;6635;13124;0;19759;5361;12364;0;17725;6763;14047;0;20810;76219;195.0;2010;True;43;6.514444444444444
77.0;Zlinszky András;1983;M1;HUN;Regnum Marianum SE;Tihany;M;48;F2/33;4661;10296;0;14957;5984;14229;0;20213;4612;11612;0;16224;6454;14630;0;21084;72478;195.0;2010;True;27;6.194700854700855
78.0;Tigyi László;1960;M3;HUN;Nudlik SE;Budapest;M;102;F3/44;4634;10514;0;15148;5776;12392;0;18168;4628;11930;0;16558;6189;14271;0;20460;70334;195.0;2010;True;50;6.011452991452992
79.0;Pálffy Tibor;1953;M4;HUN;Margita 344,2 TSE;Gödöllő;M;16;F3/45;4597;10968;0;15565;5990;13255;0;19245;4955;11657;0;16612;6031;13400;0;19431;70853;195.0;2010;True;57;6.055811965811967
80.0;Bakos Gábor;1966;M3;HUN;-;Dunakeszi;M;206;F3/46;5159;10771;0;15930;6091;12885;0;18976;4988;12669;0;17657;6504;13958;0;20462;73025;195.0;2010;True;44;6.2414529914529915
81.0;Szabó Zoltán dr.;1958;M4;HUN;-;Dunaújváros;M;220;F3/47;5558;11793;0;17351;6340;12761;0;19101;5181;11974;0;17155;6897;15011;0;21908;75515;195.0;2010;True;52;6.4542735042735035
82.0;Kinderis, Gediminas;1963;M3;LTU;-;Kaunas;M;169;F3/48;4566;10436;0;15002;6088;13113;0;19201;4481;11819;0;16300;5578;13313;0;18891;69394;195.0;2010;True;47;5.931111111111111
83.0;Ádám Attila;1979;M2;HUN;-;Debrecen;M;158;F2/34;4868;10488;0;15356;6194;12993;0;19187;5324;12353;0;17677;6906;15014;0;21920;74140;195.0;2010;True;31;6.336752136752137
84.0;Budenszki Péter;1973;M2;HUN;MAC;Budapest;M;170;F2/35;5492;11941;0;17433;7242;12767;0;20009;5511;12606;0;18117;6830;14734;0;21564;77123;195.0;2010;True;37;6.5917094017094024
85.0;Bozó Pál;1939;M5;HUN;Futóbolondok SE;Erdőkertes;M;183;F3/49;5547;12135;0;17682;6429;13105;0;19534;5135;12181;0;17316;6486;13969;0;20455;74987;195.0;2010;True;71;6.409145299145299
86.0;Zaun, Jürgen;1950;M5;GER;-;Mettmann;M;143;F3/50;5353;11947;0;17300;6567;13048;0;19615;5238;12287;0;17525;6760;14357;0;21117;75557;195.0;2010;True;60;6.457863247863248
87.0;Vollár Gyula;1971;M2;HUN;-;Pécel;M;202;F2/36;5562;11793;0;17355;6355;12745;0;19100;5342;12572;0;17914;6831;14733;0;21564;75933;195.0;2010;True;39;6.489999999999999
88.0;Strain, Alan;1966;M3;GBR;-;Peebles;M;147;F3/51;5456;11800;0;17256;6415;12954;0;19369;5238;12479;0;17717;6449;14141;0;20590;74932;195.0;2010;True;44;6.404444444444444
89.0;Tóth Iván Csaba;1974;M2;HUN;Vasemberek Klubja;;M;233;F2/37;5110;11099;0;16209;6600;13248;0;19848;4456;10561;0;15017;7475;16100;0;23575;74649;195.0;2010;True;36;6.38025641025641
90.0;Barker, Richard;1962;M3;AUT;LC MKW HAUSRUCK;Hausruck;M;139;F3/52;5183;11820;0;17003;6260;13287;0;19547;5224;12806;0;18030;6752;15541;0;22293;76873;195.0;2010;True;48;6.57034188034188
14.0;Stemler Magdolna;1984;F1;HUN;Tamási Triathlon;Tamási;F;218;N2/10;5519;11840;0;17359;6333;12750;0;19083;5533;13876;0;19409;7725;16216;0;23941;79792;195.0;2010;True;26;6.819829059829059
15.0;Berzy Judith;1973;F2;HUN;-;Budapest;F;22;N2/11;5292;11697;0;16989;6253;13391;0;19644;5180;12765;0;17945;6616;15022;0;21638;76216;195.0;2010;True;37;6.5141880341880345
91.0;Bicskei Ferenc;1966;M3;HUN;-;Budapest;M;211;F3/53;5144;11348;0;16492;6540;13707;0;20247;5459;13656;0;19115;6806;14333;0;21139;76993;195.0;2010;True;44;6.5805982905982905
92.0;Kiss Gábor Gyula;1979;M2;HUN;-;Esztergom;M;188;F2/38;4956;11638;0;16594;6210;14228;0;20438;5083;12572;0;17655;6568;14490;0;21058;75745;195.0;2010;True;31;6.473931623931624
16.0;Eichner, Sigrid;1940;F4;GER;-;Berlin;F;200;N3/5;5746;12478;0;18224;6716;13815;0;20531;5440;12980;0;18420;6807;14792;0;21599;78774;195.0;2010;True;70;6.732820512820513
17.0;Hack Zsanett;1984;F1;HUN;-;Nyergesújfalu;F;27;N2/12;5013;11223;0;16236;6131;13745;0;19876;4898;11627;0;16525;6577;15783;0;22360;74997;195.0;2010;True;26;6.41
93.0;Ajkay Antal;1950;M5;HUN;-;Budapest;M;160;F3/54;5536;12335;0;17871;6815;14206;0;21021;5716;14168;0;19884;6905;15056;0;21961;80737;195.0;2010;True;60;6.90059829059829
18.0;Fáczán Györgyi;1977;F2;HUN;-;Ravazd;F;156;N2/13;5513;12254;0;17767;6813;14024;0;20837;5788;13945;0;19733;6900;14732;0;21632;79969;195.0;2010;True;33;6.834957264957264
94.0;Katz Rudolf;1953;M4;HUN;Kanizsai Futóklub;Nagykanizsa;M;225;F3/55;6016;12973;0;18989;6939;14033;0;20972;5801;14120;0;19921;7315;16000;0;23315;83197;195.0;2010;True;57;7.1108547008547
95.0;Maczó András;1949;M5;HUN;Futapest;Budapest;M;26;F3/56;6331;14037;0;20368;0;14040;0;14040;0;0;0;0;7086;15904;0;22990;57398;195.0;2010;True;61;4.905811965811965
19.0;Bohusné Nemes Krisztina;1970;F3;HUN;-;Budapest;F;155;N3/6;5514;12255;0;17769;6902;14016;0;20918;5788;13995;0;19783;7553;16603;0;24156;82626;195.0;2010;True;40;7.062051282051281
1.0;Fajfrik Zoltán;1986;M1;HUN;Honvéd Bercsényi SE;Hódmezővásárhely;M;135;1 /(18-24);3729;4075;4084;11888;4041;4026;5591;13658;0;7742;7648;15390;4134;4685;4503;13322;54258;195.0;2009;True;23;4.637435897435897
2.0;Rostás Pál;1961;M3;HUN;Napraforgó Futóklub;Hódmezővásárhely;M;153;1 /(40-);3718;4098;4259;12075;4315;4434;6194;14943;7821;4618;3660;16099;4404;5243;5580;15227;58344;195.0;2009;True;48;4.986666666666666
3.0;Juhász Péter;1970;M2;HUN;Oxygen wellness;Budapest;M;38;1 /(25-39);3825;4422;4937;13184;4427;4503;6404;15334;7855;4841;3867;16563;4403;5235;5394;15032;60113;195.0;2009;True;39;5.1378632478632476
4.0;Filip Krisztián;1976;M2;HUN;MATASZ Székesfehérvár;Budapest;M;57;2 /(25-39);3823;4425;4936;13184;4432;4506;6404;15342;7849;4844;3864;16557;4404;5234;5394;15032;60115;195.0;2009;True;33;5.1380341880341875
5.0;Ónadi Imre;1971;M2;HUN;Oxigén;Debrecen;M;176;3 /(25-39);4084;4633;4785;13502;4647;4768;6548;15963;3822;4870;7882;16574;4804;5222;5168;15194;61233;195.0;2009;True;38;5.233589743589743
6.0;Guidolin, Gianpietro;1960;M3;ITA;-;Seraing;M;137;2 /(40-);3824;4425;4739;12988;4453;4475;6456;15384;3945;4983;3710;12638;4588;5925;5744;16257;57267;195.0;2009;True;49;4.894615384615385
7.0;Korányi Balázs;1974;M2;HUN;Futóbolondok SE;Budapest;M;7;4 /(25-39);4080;4628;4795;13503;4662;4764;6582;16008;3820;5090;3798;12708;4804;5469;5061;15334;57553;195.0;2009;True;35;4.9190598290598295
8.0;Szénai László dr.;1966;M3;HUN;Szondi SE;Székesfehérvár;M;51;3 /(40-);3764;4615;5235;13614;4748;5138;7044;16930;3792;4990;4043;12825;4890;5627;4959;15476;58845;195.0;2009;True;43;5.029487179487179
9.0;Lőw András;1967;M3;HUN;Hajsza SE;Budapest;M;133;4 /(40-);3942;4492;4798;13232;4416;4550;7601;16567;3924;5105;3930;12959;4754;5704;5654;16112;58870;195.0;2009;True;42;5.0316239316239315
10.0;Herbák Gergő;1980;M2;HUN;-;Budajenő;M;164;5 /(25-39);3769;4489;5916;14174;4406;4732;7349;16487;3674;5033;4007;12714;4616;5573;5326;15515;58890;195.0;2009;True;29;5.033333333333333
11.0;Szőke Tamás;1970;M2;HUN;-;Székesfehérvár;M;14;6 /(25-39);4577;5064;5309;14950;4813;4813;6679;16305;3921;5111;3928;12960;4754;5438;5267;15459;59674;195.0;2009;True;39;5.1003418803418805
12.0;Virág Zoltán;1979;M2;HUN;Szolnoki HSE;Szolnok (Szandaszőlős);M;60;7 /(25-39);3731;4300;4980;13011;4425;4497;6448;15370;3644;4839;4413;12896;4954;6633;6881;18468;59745;195.0;2009;True;30;5.106410256410256
13.0;Vrábel Miklós;1968;M3;HUN;Gróf Hadik SE;Pécs;M;178;5 /(40-);4232;5025;5592;14849;4824;4818;7020;16662;3929;5091;3927;12947;4756;5437;5429;15622;60080;195.0;2009;True;41;5.1350427350427355
14.0;Farkas László;1967;M3;HUN;Futóbolondok SE;Veresegyház;M;20;6 /(40-);4296;4821;4919;14036;5016;5101;6838;16955;4189;5498;4093;13780;5181;5764;5355;16300;61071;195.0;2009;True;42;5.21974358974359
15.0;Simon Zoltán;1970;M2;HUN;-;Solymár;M;37;8 /(25-39);4081;4861;6110;15052;5007;5010;6767;16784;4111;5293;3844;13248;5181;5677;5146;16004;61088;195.0;2009;True;39;5.2211965811965815
16.0;Salamon István;1962;M3;HUN;-;Mezőtárkány;M;34;7 /(40-);4316;5040;5742;15098;5018;5029;7266;17313;4041;5364;4062;13467;5085;5836;5581;16502;62380;195.0;2009;True;47;5.331623931623932
17.0;Bajcsi Sándor;1956;M4;HUN;Óbudai Futókör;Üröm;M;15;8 /(40-);4039;4713;5485;14237;4881;5137;7553;17571;4055;5560;4256;13871;5087;5837;5781;16705;62384;195.0;2009;True;53;5.331965811965812
18.0;Garda Árpád Endre;1962;M3;HUN;Debreceni Honvéd SE;Debrecen;M;68;9 /(40-);4086;4631;4790;13507;4647;4769;6861;16277;3814;5064;4444;13322;4879;6327;8081;19287;62393;195.0;2009;True;47;5.3327350427350435
19.0;Majzik Gergő;1980;M2;HUN;-;Budapest;M;112;9 /(25-39);0;0;15501;15501;5332;5232;7091;17655;4176;5417;4064;13657;5184;5661;5245;16090;62903;195.0;2009;True;29;5.376324786324787
20.0;Papp Sándor;1970;M2;HUN;Debreceni Rendőr SE;Vámospércs;M;120;10 /(25-39);4759;5403;5378;15540;5463;5358;7168;17989;4336;5524;4023;13883;5463;5833;5355;16651;64063;195.0;2009;True;39;5.475470085470086
1.0;Makai Viktória;1980;F2;HUN;-;Budapest;F;119;1 /(25-39);4357;0;10291;14648;4852;5205;7665;17722;4268;5782;4521;14571;5319;6232;6066;17617;64558;195.0;2009;True;29;5.517777777777778
21.0;Kardoss Lóránt Imre;1973;M2;HUN;Szaratov II. Klub;Tura;M;121;11 /(25-39);4166;4823;5400;14389;4864;5150;8053;18067;4117;5745;4789;14651;5044;6113;6336;17493;64600;195.0;2009;True;36;5.521367521367522
22.0;Kiss Péter;1986;M1;HUN;Margita 344,2 TSE;Gyöngyös;M;17;2 /(18-24);4033;4912;5352;14297;4862;5170;7727;17759;3904;5709;4342;13955;5222;6760;6610;18592;64603;195.0;2009;True;23;5.521623931623932
23.0;Pók János;1963;M3;HUN;Axiál Kft.;Gárdony (Agárd);M;33;10 /(40-);4575;5067;5305;14947;5141;5304;7450;17895;4289;5683;4225;14197;5531;6287;5823;17641;64680;195.0;2009;True;46;5.528205128205128
24.0;Rumi Mihály Róbert;1974;M2;HUN;Sunderland Strollers;Gárdony;M;9;12 /(25-39);4575;5070;5302;14947;5149;5305;7452;17906;4285;5687;4224;14196;5531;6288;5820;17639;64688;195.0;2009;True;35;5.52888888888889
25.0;Kreszta Zoltán;1970;M2;HUN;-;Budapest;M;11;13 /(25-39);4310;0;10338;14648;4893;5208;7923;18024;4353;5840;4521;14714;5321;6229;5910;17460;64846;195.0;2009;True;39;5.542393162393163
26.0;Bene Ferenc;1956;M4;HUN;Knorr-Bremse;Kecskemét;M;177;11 /(40-);4482;5004;5179;14665;5394;5292;7348;18034;4415;5758;4399;14572;5479;6165;5998;17642;64913;195.0;2009;True;53;5.548119658119659
27.0;Lukovics Béla;1953;M4;HUN;Békéscsabai AC;Békéscsaba;M;58;12 /(40-);4502;5157;5422;15081;0;0;18981;18981;4228;5533;4062;13823;5389;6024;5657;17070;64955;195.0;2009;True;56;5.5517094017094015
28.0;Domán Gábor;1960;M3;HUN;Tapolca Honvéd SE;Tapolca;M;56;13 /(40-);3989;4955;5858;14802;4883;4871;7259;17013;4144;5852;4538;14534;4995;6773;7517;19285;65634;195.0;2009;True;49;5.60974358974359
29.0;Lusskandl, Gerhard;1969;M3;AUT;-;Ober-Grafendorf;M;147;14 /(25-39);4476;4876;5247;14599;5408;5307;7506;18221;4419;5481;4150;14050;5864;6556;6401;18821;65691;195.0;2009;True;40;5.614615384615385
30.0;Sipos Sándor;1957;M4;HUN;-;Budapest;M;173;14 /(40-);4548;5188;5432;15168;5363;5444;7669;18476;4382;5965;4469;14816;5445;6157;5878;17480;65940;195.0;2009;True;52;5.635897435897436
31.0;Nagyváthy János;1964;M3;HUN;Futóbolondok SE;Budakeszi;M;115;15 /(40-);4431;5007;5433;14871;5162;5567;7158;17887;4476;6143;4961;15580;5743;6416;5617;17776;66114;195.0;2009;True;45;5.650769230769232
2.0;Prinzhausen Judit;1978;F2;HUN;-;Budapest;F;160;2 /(25-39);4372;5183;5640;15195;5452;5603;7697;18752;4447;5873;4381;14701;5338;6216;6064;17618;66266;195.0;2009;True;31;5.663760683760684
32.0;Séra István;1960;M3;HUN;-;Budapest;M;36;16 /(40-);4874;5576;5856;16306;5490;5484;7522;18496;4395;5709;4206;14310;5478;6115;5641;17234;66346;195.0;2009;True;49;5.67059829059829
33.0;Gilmer Paul;1958;M4;HUN;-;Budapest;M;169;17 /(40-);5011;0;11183;16194;5597;5449;7310;18356;4383;5749;4261;14393;5897;6133;5614;17644;66587;195.0;2009;True;51;5.691196581196581
34.0;Bacsa László;1978;M2;HUN;-;Piricse;M;126;15 /(25-39);4767;5397;5377;15541;5461;5356;7132;17949;4338;5530;4020;13888;5856;6969;6442;19267;66645;195.0;2009;True;31;5.696153846153846
35.0;Kerényi Farkas;1977;M2;HUN;Farkas Vidor SE;Budapest;M;157;16 /(25-39);4483;5277;6195;15955;5514;5643;7768;18925;4347;0;10198;14545;5526;6295;5733;17554;66979;195.0;2009;True;32;5.724700854700854
36.0;Láng István;1957;M4;HUN;Messer Futóklub;Göd (Alsógöd);M;30;18 /(40-);4539;5178;5938;15655;5278;5393;7968;18639;4373;5985;4492;14850;5566;6513;6320;18399;67543;195.0;2009;True;52;5.772905982905983
37.0;Toobe, Peter;1947;M5;GER;-;Sinsheim;M;149;19 /(40-);4869;5571;5763;16203;5512;5588;7473;18573;4432;6024;4554;15010;5551;6403;6148;18102;67888;195.0;2009;True;62;5.802393162393162
38.0;Huser, Peter;1954;M4;SUI;-;Baar;M;150;19 /(40-);4868;5572;5764;16204;5510;5588;7473;18571;4434;6022;4555;15011;5551;6401;6150;18102;67888;195.0;2009;True;55;5.802393162393162
39.0;Holczer Zoltán;1974;M2;HUN;Spuri SC;Budapest;M;116;17 /(25-39);4314;5355;7988;17657;5338;5737;7546;18621;4335;5933;4222;14490;5442;6267;5656;17365;68133;195.0;2009;True;35;5.823333333333333
40.0;Günthner, Josef;1956;M4;AUT;-;Linz;M;197;21 /(40-);4698;5640;6097;16435;5587;5664;7617;18868;4469;5938;4479;14886;5796;6400;5972;18168;68357;195.0;2009;True;53;5.842478632478632
41.0;Szabó Béla;1963;M3;HUN;-;Keszthely;M;40;22 /(40-);4368;5569;6511;16448;5222;5391;7961;18574;4354;5986;4691;15031;5566;6512;6319;18397;68450;195.0;2009;True;46;5.85042735042735
42.0;Mühlbachler, Ambros;1959;M3;AUT;-;Pregarten;M;198;23 /(40-);4681;5645;6216;16542;5580;5663;7652;18895;4465;5932;4478;14875;5796;6398;5970;18164;68476;195.0;2009;True;50;5.852649572649573
3.0;Peredy Lúcia Julianna;1971;F2;HUN;Csigaház SC;Budapest;F;117;3 /(25-39);5022;5660;5836;16518;5947;5583;7531;19061;4588;6123;4454;15165;5647;6337;5848;17832;68576;195.0;2009;True;38;5.861196581196581
43.0;Ratz, Winfried;1968;M3;AUT;-;Altenberg bei Linz;M;196;24 /(40-);4706;5625;6103;16434;5579;6150;7851;19580;4465;5935;4480;14880;5793;6399;5975;18167;69061;195.0;2009;True;41;5.9026495726495725
44.0;Hertinger, Bernhard;1955;M4;GER;-;Laudenbach;M;166;25 /(40-);5353;6208;6145;17706;5683;5654;7728;19065;4560;5955;4477;14992;5573;6456;6001;18030;69793;195.0;2009;True;54;5.9652136752136755
4.0;Gehmacher, Christine;1965;F3;GER;-;Bergen;F;168;1 /(40-);5271;5875;6145;17291;5721;5654;7759;19134;4620;6228;4535;15383;5573;6514;6011;18098;69906;195.0;2009;True;44;5.974871794871794
45.0;Pintér Sándor;1975;M2;HUN;Pénzügyőr SE;Gödöllő;M;125;18 /(25-39);4474;5009;5896;15379;5432;5848;8799;20079;4400;6046;4721;15167;5885;7365;6213;19463;70088;195.0;2009;True;34;5.990427350427351
5.0;Gyebnár Éva;1979;F2;HUN;Békési DAC;Békéscsaba;F;154;4 /(25-39);5240;6129;6417;17786;5862;5918;7848;19628;4846;5827;4096;14769;5894;6293;5882;18069;70252;195.0;2009;True;30;6.004444444444444
46.0;Pálffy Tibor;1953;M4;HUN;Margita 344,2 TSE;Gödöllő;M;16;26 /(40-);4498;5353;6327;16178;5250;5344;8348;18942;4726;6108;4622;15456;5971;7216;7148;20335;70911;195.0;2009;True;56;6.06076923076923
47.0;Evetovics Milán;1980;M2;HUN;Futóbolondok SE;Budapest;M;174;19 /(25-39);4938;5434;6204;16576;5812;0;15201;21013;4250;5507;4630;14387;6014;6660;6334;19008;70984;195.0;2009;True;29;6.067008547008546
6.0;Máténé Varju Edit;1971;F2;HUN;MATASZ Székesfehérvár;Székesfehérvár;F;122;5 /(25-39);4884;5676;6012;16572;5667;5780;8154;19601;4735;6179;4494;15408;5916;6833;6766;19515;71096;195.0;2009;True;38;6.076581196581197
48.0;Leel-Őssy István;1972;M2;HUN;Hajsza SE;Debrecen;M;132;20 /(25-39);4604;5535;5917;16056;5726;6111;8702;20539;4590;6309;4583;15482;5650;6631;6766;19047;71124;195.0;2009;True;37;6.078974358974359
49.0;Soós Péter;1970;M2;HUN;Szondi SE;Székesfehérvár;M;39;21 /(25-39);4884;5676;5992;16552;0;0;19143;19143;4344;6158;4511;15013;5941;7218;7373;20532;71240;195.0;2009;True;39;6.088888888888889
50.0;Vaczkó Zsolt;1971;M2;HUN;-;Budapest;M;110;22 /(25-39);4891;5482;6131;16504;5459;5656;7801;18916;4755;7089;5125;16969;5682;7245;6850;19777;72166;195.0;2009;True;38;6.168034188034188
51.0;Wagemann, Eberhard;1952;M4;GER;-;Berlin;M;165;27 /(40-);5424;6178;6234;17836;5856;6294;8765;20915;4620;6189;4527;15336;5793;6397;5972;18162;72249;195.0;2009;True;57;6.175128205128206
52.0;Zlinszky András;1983;M1;HUN;Regnum Marianum SE;Tihany;M;48;23 /(25-39);4478;5493;6622;16593;5784;5983;8520;20287;4822;6565;4719;16106;0;13401;6307;19708;72694;195.0;2009;True;26;6.213162393162393
53.0;Posztobányi Zoltán;1963;M3;HUN;-;Kalocsa;M;111;28 /(40-);4444;5502;6503;16449;5365;5604;8049;19018;4446;6346;5389;16181;5975;8240;7325;21540;73188;195.0;2009;True;46;6.2553846153846155
54.0;Lukács Albert;1974;M2;HUN;-;Budaörs;M;180;24 /(25-39);4807;5691;6488;16986;5224;5538;8757;19519;4579;5806;4821;15206;6661;7310;7668;21639;73350;195.0;2009;True;35;6.269230769230769
7.0;Pilarova, Ivana;1963;F3;CZE;-;Liberec;F;141;2 /(40-);4934;5947;6177;17058;5793;6103;8641;20537;4838;6663;4957;16458;6038;7015;6620;19673;73726;195.0;2009;True;46;6.3013675213675215
55.0;Babarczy Tamás;1963;M3;HUN;-;Gödöllő;M;113;29 /(40-);5237;5987;6407;17631;5798;6029;8233;20060;4827;6498;4989;16314;6042;7079;7033;20154;74159;195.0;2009;True;46;6.338376068376069
56.0;Jánosi Kornél dr.;1964;M3;HUN;Buda Fitness;Szentendre;M;114;29 /(40-);5235;5989;6405;17629;5798;6029;8236;20063;4828;6498;4987;16313;6040;7079;7035;20154;74159;195.0;2009;True;45;6.338376068376069
57.0;Fodor Gábor;1983;M1;HUN;Pénzügyőr SE;Celldömölk;M;124;25 /(25-39);4475;5660;6665;16800;5589;6012;8269;19870;4691;7022;5064;16777;5894;7538;7403;20835;74282;195.0;2009;True;26;6.348888888888888
58.0;Kollár Zoltán;1965;M3;HUN;Knorr-Bremse;Budapest;M;55;31 /(40-);5462;6343;6676;18481;6398;6296;8648;21342;5123;6637;4787;16547;5962;6573;5887;18422;74792;195.0;2009;True;44;6.392478632478633
59.0;Czaltig Zsolt;1974;M2;HUN;-;Százhalombatta;M;129;26 /(25-39);4889;5471;6146;16506;5468;5649;8130;19247;4497;6141;4841;15479;5889;8499;9393;23781;75013;195.0;2009;True;35;6.411367521367522
60.0;Dáva Iván;1960;M3;HUN;-;Budaörs;M;23;32 /(40-);4170;5199;6132;15501;5341;6148;9446;20935;4489;6709;5762;16960;6119;8387;8025;22531;75927;195.0;2009;True;49;6.489487179487179
61.0;Durst János dr.;1967;M3;HUN;-;Szentendre;M;12;33 /(40-);5621;6807;7374;19802;6482;6562;8450;21494;5112;6632;4600;16344;5848;6664;6059;18571;76211;195.0;2009;True;42;6.513760683760684
62.0;Klam Csaba;1970;M2;HUN;-;Soltvadkert;M;29;27 /(25-39);4829;5670;6577;17076;5779;6489;9028;21296;4819;6982;5350;17151;6113;7743;7542;21398;76921;195.0;2009;True;39;6.5744444444444445
8.0;Országné Faragó Éva;1966;F3;HUN;TRIA-TÚRA SE;Kecskemét;F;32;3 /(40-);4831;5674;6571;17076;5779;6490;9037;21306;4814;6982;5351;17147;6115;7741;7543;21399;76928;195.0;2009;True;43;6.575042735042736
63.0;Tigyi László;1960;M3;HUN;Nudlik SE;Budapest;M;102;34 /(40-);4629;6080;7470;18179;5891;6489;9589;21969;4673;6227;5115;16015;5874;7093;7866;20833;76996;195.0;2009;True;49;6.580854700854701
64.0;Prekopp Péter dr.;1978;M2;HUN;-;Budapest;M;152;28 /(25-39);5383;6299;6750;18432;6151;6447;9065;21663;5303;7101;5354;17758;6682;7686;6957;21325;79178;195.0;2009;True;31;6.7673504273504275
65.0;Szabó Balázs dr.;1970;M2;HUN;-;Budapest;M;103;29 /(25-39);5383;6300;6747;18430;6151;6447;9066;21664;5305;7100;5354;17759;6681;7687;6959;21327;79180;195.0;2009;True;39;6.767521367521368
9.0;Andrews, Caitlin;1980;F2;USA;-;Firenze;F;144;6 /(25-39);5169;5716;6092;16977;5540;5729;8631;19900;5258;7098;5549;17905;7232;8378;8895;24505;79287;195.0;2009;True;29;6.776666666666667
10.0;Berzy Judith;1973;F2;HUN;-;Budapest;F;22;7 /(25-39);5054;6288;6909;18251;5938;6752;8929;21619;5252;7431;5546;18229;6408;7719;7128;21255;79354;195.0;2009;True;36;6.782393162393162
66.0;Morócz József;1969;M3;HUN;-;Budapest;M;107;30 /(25-39);5239;6130;6416;17785;5864;5917;8256;20037;4846;6921;5950;17717;5813;8979;9130;23922;79461;195.0;2009;True;40;6.791538461538461
67.0;Komar, Ewald;1950;M4;GER;-;Weinheim;M;140;35 /(40-);5481;6470;7184;19135;6818;6939;9304;23061;5304;6834;4939;17077;6582;7280;6998;20860;80133;195.0;2009;True;59;6.848974358974359
68.0;Basel, Daniel;1952;M4;GER;-;Weinheim;M;139;36 /(40-);5554;6404;7178;19136;6811;6938;9309;23058;5310;6838;4932;17080;6586;7279;6999;20864;80138;195.0;2009;True;57;6.84940170940171
69.0;Szászi Tamás;1979;M2;HUN;-;Sopron;M;134;31 /(25-39);5110;5898;6531;17539;6386;6827;10012;23225;5327;7302;5499;18128;6690;7703;7024;21417;80309;195.0;2009;True;30;6.864017094017094
70.0;Dragschitz, René;1971;M2;GER;-;Neusiedl am See;M;167;32 /(25-39);5615;6574;6963;19152;6383;6453;8307;21143;5149;7155;5551;17855;6512;8031;7653;22196;80346;195.0;2009;True;38;6.867179487179487
71.0;Jónás Gyula;1976;M2;HUN;-;Budapest;M;172;33 /(25-39);5146;6030;6151;17327;6244;6639;8884;21767;5533;7261;5699;18493;6992;8381;7606;22979;80566;195.0;2009;True;33;6.885982905982906
72.0;Neumann, Klaus;1952;M4;GER;-;Stuttgart;M;138;37 /(40-);5640;7114;7458;20212;6792;6933;9454;23179;5030;6671;5121;16822;6456;7405;7261;21122;81335;195.0;2009;True;57;6.951709401709401
11.0;Nagy Nóra;1965;F3;HUN;-;Budapest;F;123;4 /(40-);5450;6504;6820;18774;6487;6500;9389;22376;5350;7060;5595;18005;6775;7947;7911;22633;81788;195.0;2009;True;44;6.990427350427351
73.0;Ambrus Csaba;1981;M2;HUN;-;Budapest;M;151;34 /(25-39);4550;0;12104;16654;6026;6668;9512;22206;5158;7693;6010;18861;6880;8911;8587;24378;82099;195.0;2009;True;28;7.017008547008547
74.0;Zaun, Jürgen;1950;M4;GER;-;Mettmann;M;143;38 /(40-);5328;6235;7494;19057;6425;6650;9611;22686;5270;7224;5693;18187;6440;7875;8348;22663;82593;195.0;2009;True;59;7.059230769230769
75.0;Nagygyörgy Attila;1974;M2;HUN;Kőrösi Nyulak;Kecskemét;M;131;35 /(25-39);0;0;18062;18062;5896;7234;9277;22407;5296;7923;5612;18831;7099;7931;8702;23732;83032;195.0;2009;True;35;7.096752136752136
76.0;Bailey, Howard;1956;M4;GBR;-;Thames Ditton;M;148;39 /(40-);5276;6461;7573;19310;6458;6637;9694;22789;5289;7408;5831;18528;6707;8031;8049;22787;83414;195.0;2009;True;53;7.1294017094017095
77.0;Horváth Csaba;1978;M2;HUN;-;Dunaszerdahely;M;127;36 /(25-39);5243;6087;6852;18182;6177;6577;9402;22156;0;0;17834;17834;7551;9236;9353;26140;84312;195.0;2009;True;31;7.206153846153846
12.0;Sacher, Grace;1954;F4;GER;-;Stuttgart;F;145;5 /(40-);5677;7054;7482;20213;6800;6926;9622;23348;5610;7785;6042;19437;6738;7846;7034;21618;84616;195.0;2009;True;55;7.232136752136752
78.0;Kopecsni, Roland;1980;M2;SVK;-;Dunaszerdahely;M;159;37 /(25-39);5245;6088;6979;18312;6171;6580;9176;21927;5238;7892;6055;19185;7360;9351;8695;25406;84830;195.0;2009;True;29;7.25042735042735
79.0;Preisler, Horst;1935;M5;GER;-;Hamburg;M;146;40 /(40-);5699;6942;7109;19750;6634;6655;9370;22659;5735;7652;5701;19088;6762;8449;8321;23532;85029;195.0;2009;True;74;7.267435897435898
13.0;Eichner, Sigrid;1940;F4;GER;-;Berlin;F;200;6 /(40-);5520;6803;6823;19146;6449;6915;10103;23467;5619;7881;6091;19591;6862;8764;8848;24474;86678;195.0;2009;True;69;7.408376068376069
80.0;Werner, Nickl;1954;M4;AUT;-;Belzig;M;142;41 /(40-);5618;7106;7483;20207;6797;6933;9854;23584;5613;7954;6193;19760;6751;8852;8851;24454;88005;195.0;2009;True;55;7.521794871794872
14.0;Hack Zsanett;1984;F1;HUN;-;Nyergesújfalu;F;27;1 /(18-24);4904;6419;7707;19030;6119;7366;10117;23602;5416;8530;6682;20628;6386;9130;9552;25068;88328;195.0;2009;True;25;7.54940170940171
15.0;Turcziné Soós Éva;1980;F2;HUN;-;Tápiószecső;F;105;8 /(25-39);5484;7337;7860;20681;6389;6819;10031;23239;0;0;19918;19918;6692;8905;9145;24742;88580;195.0;2009;True;29;7.570940170940171
81.0;Hack Román Antal;1974;M2;HUN;-;Nyergesújfalu;M;25;38 /(25-39);4903;6421;7707;19031;6118;7368;10114;23600;5416;8999;6217;20632;7692;10092;7600;25384;88647;195.0;2009;True;35;7.576666666666667
82.0;Varadi-Staubert, Arpad;1973;M2;GER;-;Wolfen;M;136;39 /(25-39);5656;7083;7770;20509;6800;7387;10541;24728;5607;8097;6150;19854;6794;9005;8221;24020;89111;195.0;2009;True;36;7.616324786324786
83.0;Maczó András;1949;M5;HUN;Futapest;Budapest;M;26;42 /(40-);5911;7358;7980;21249;6883;7416;10299;24598;5754;8230;6162;20146;7280;9197;8447;24924;90917;195.0;2009;True;60;7.77068376068376
84.0;Sas Zoltán;1965;M3;HUN;OTP Futókör;Budapest;M;108;43 /(40-);4863;6434;7881;19178;6466;7118;10742;24326;5784;0;15412;21196;7379;0;19140;26519;91219;195.0;2009;True;44;7.796495726495726
85.0;Korcsmáros Tamás;1972;M2;HUN;-;Békéscsaba;M;109;40 /(25-39);6116;7142;7926;21184;7547;8106;10595;26248;6533;8866;6631;22030;8279;0;16049;24328;93790;195.0;2009;True;37;8.016239316239316
86.0;Budenszki Péter;1973;M2;HUN;MAC;Budapest;M;170;41 /(25-39);5586;7113;7546;20245;6799;7158;10690;24647;5884;9071;7598;22553;8017;9419;9237;26673;94118;195.0;2009;True;36;8.044273504273505
1.0;Sipos Balázs;1978;M2;HUN;TTT-HSE;Budapest;M;13;1 (F/2);4062;4548;4435;13045;4636;4675;6252;15563;3775;4952;7866;16593;5065;5367;4999;15431;60632;195.0;2008;True;30;5.182222222222222
2.0;Ács László;1961;M3;HUN;TRI-CO TK;Nagykanizsa;M;21;1 (F/3);4067;4577;4825;13469;4582;4643;6469;15694;3769;4975;3770;12514;5098;5657;5042;15797;57474;195.0;2008;True;47;4.912307692307692
3.0;Hegedűs István;1973;M2;HUN;TTT-HSE;Tata;M;70;2 (F/2);4059;4710;5398;14167;4668;4849;6828;16345;3745;4656;3752;12153;4835;5370;4971;15176;57841;195.0;2008;True;35;4.943675213675213
4.0;Dezső Sándor;1965;M3;HUN;Napraforgó Futóklub;;M;6;2 (F/3);3649;4186;4604;12439;4552;4631;7153;16336;3720;5111;4291;13122;5100;5657;5402;16159;58056;195.0;2008;True;43;4.9620512820512825
5.0;Korányi Balázs;1974;M2;HUN;Futóbolondok SE;Budapest;M;7;3 (F/2);4065;0;9456;13521;4940;5019;7025;16984;3967;4903;3750;12620;5211;5780;5157;16148;59273;195.0;2008;True;34;5.066068376068376
6.0;Simon Zoltán;1970;M2;HUN;-;Solymár;M;37;4 (F/2);4231;4703;5145;14079;4947;4893;6710;16550;3934;4897;3778;12609;5268;5723;5219;16210;59448;195.0;2008;True;38;5.081025641025641
1.0;Kiss Zita;1967;F3;HUN;-;Budapest;F;67;1 (N/3);4565;5027;4965;14557;4959;4921;6765;16645;3969;5225;3920;13114;5255;5751;5444;16450;60766;195.0;2008;True;41;5.193675213675213
7.0;Baranyai Krisztián;1975;M2;HUN;Szolnoki HSE;Törtel;M;61;5 (F/2);3682;4289;5351;13322;4567;4775;7352;16694;3900;5103;4192;13195;5727;5842;6123;17692;60903;195.0;2008;True;33;5.205384615384615
8.0;Domán Gábor;1960;M3;HUN;Tapolca Honvéd SE;Tapolca;M;56;3 (F/3);3862;4524;4811;13197;4569;4850;8273;17692;3951;5294;4372;13617;4953;6074;5741;16768;61274;195.0;2008;True;48;5.237094017094017
9.0;Szénai László dr.;1966;M3;HUN;Szondi SE;Székesfehérvár;M;51;4 (F/3);4222;4728;5374;14324;5219;5204;7760;18183;3769;4984;4024;12777;5201;6095;5187;16483;61767;195.0;2008;True;42;5.27923076923077
10.0;Juhász Péter;1970;M2;HUN;Spuri SC;Budapest;M;38;6 (F/2);3953;4558;4923;13434;4465;4619;7271;16355;3694;5114;4588;13396;5287;6712;6922;18921;62106;195.0;2008;True;38;5.3082051282051275
11.0;Filip Krisztián;1976;M2;HUN;-;Budapest;M;57;7 (F/2);4528;5178;5789;15495;5716;5794;7802;19312;3931;4882;3884;12697;4976;5277;4974;15227;62731;195.0;2008;True;32;5.361623931623932
12.0;Farkas László;1967;M3;HUN;Futóbolondok SE;Veresegyház;M;20;5 (F/3);4597;4996;5145;14738;5316;5221;7342;17879;4439;5585;4162;14186;5293;6084;5848;17225;64028;195.0;2008;True;41;5.472478632478633
13.0;Láng István;1957;M4;HUN;Messer Futóklub;Göd (Alsógöd);M;30;6 (F/3);4595;5000;5146;14741;5302;5223;7347;17872;4444;5587;4161;14192;5295;6082;5848;17225;64030;195.0;2008;True;51;5.472649572649573
14.0;Taskovics Sándor;1975;M2;HUN;-;Rém;M;42;8 (F/2);4527;5176;5792;15495;5722;5800;7792;19314;4222;5602;4191;14015;5158;5385;5061;15604;64428;195.0;2008;True;33;5.506666666666667
15.0;Virág Zoltán;1979;M2;HUN;Szolnoki HSE;Szolnok (Szandaszőlős);M;60;9 (F/2);4584;5170;7337;17091;5544;5282;6756;17582;4126;5224;3873;13223;5371;5636;5643;16650;64546;195.0;2008;True;29;5.516752136752137
16.0;Vindics István;1964;M3;HUN;Futóbolondok SE;Mecseknádasd;M;46;7 (F/3);4098;4785;5370;14253;4943;4947;7609;17499;3825;5325;4707;13857;5381;6919;7311;19611;65220;195.0;2008;True;44;5.574358974358974
17.0;Farkas Tibor;1961;M3;HUN;T-Online;Budapest;M;18;8 (F/3);4065;4596;5398;14059;0;0;17828;17828;4048;5602;4642;14292;5416;6859;7332;19607;65786;195.0;2008;True;47;5.622735042735043
18.0;Visy Ferenc;1947;M5;HUN;Sirály;Nagykovácsi;M;47;9 (F/3);4507;5146;5650;15303;5082;5269;8464;18815;4253;5653;4527;14433;5299;6468;6735;18502;67053;195.0;2008;True;61;5.73102564102564
19.0;Garda Árpád Endre;1962;M3;HUN;Debreceni Honvéd SE;Debrecen;M;68;10 (F/3);3971;4859;8757;17587;4585;4811;10142;19538;3922;5147;4265;13334;5143;5755;5877;16775;67234;195.0;2008;True;46;5.746495726495726
20.0;Lukovics Béla;1953;M4;HUN;Békéscsabai AC;Békéscsaba;M;58;11 (F/3);4895;5427;5609;15931;5741;5659;7579;18979;4329;5597;4176;14102;6030;6403;5846;18279;67291;195.0;2008;True;55;5.751367521367522
21.0;Bajcsi Sándor;1956;M4;HUN;Üröm SE;Üröm;M;15;12 (F/3);3976;4902;5848;14726;5174;5774;9245;20193;4252;5985;4842;15079;5341;6293;6126;17760;67758;195.0;2008;True;52;5.791282051282051
22.0;Agárdi Péter;1968;M3;HUN;-;;M;53;10 (F/2);5172;5825;5757;16754;5649;5629;7377;18655;4596;5663;4285;14544;6056;6405;5825;18286;68239;195.0;2008;True;40;5.832393162393162
23.0;Rumi Mihály Róbert;1974;M2;HUN;Sunderland Strollers;Gárdony;M;9;11 (F/2);5039;5633;5547;16219;5700;5682;7457;18839;4590;5657;4240;14487;5993;6540;6216;18749;68294;195.0;2008;True;34;5.837094017094017
24.0;Pók János;1963;M3;HUN;Axiál Kft.;Gárdony (Agárd);M;33;13 (F/3);5037;5633;5550;16220;5738;5642;7457;18837;4590;5660;4238;14488;5995;6538;6217;18750;68295;195.0;2008;True;45;5.837179487179487
25.0;Lengyel Tibor;1962;M3;HUN;MATASZ Székesfehérvár;Székesfehérvár;M;65;14 (F/3);4585;5041;5537;15163;5304;5531;8021;18856;4401;5990;4372;14763;6003;7864;6116;19983;68765;195.0;2008;True;46;5.877350427350427
26.0;Kiss Péter;1986;M1;HUN;Margita 344,2 TSE;Gyöngyös;M;17;1 (F/1);3958;4778;5752;14488;4999;6314;9215;20528;4360;6262;6207;16829;5802;6597;6391;18790;70635;195.0;2008;True;22;6.037179487179487
27.0;Pálffy Tibor;1953;M4;HUN;Margita 344,2 TSE;Gödöllő;M;16;15 (F/3);4562;5359;6229;16150;5334;5769;8883;19986;0;10356;5146;15502;5800;6597;6649;19046;70684;195.0;2008;True;55;6.041367521367521
28.0;Szőke Tamás;1970;M2;HUN;Szondi SE;Székesfehérvár;M;14;12 (F/2);4898;5560;6012;16470;5751;5869;8624;20244;4457;5842;5236;15535;6048;6693;6628;19369;71618;195.0;2008;True;38;6.121196581196582
29.0;Szántó Ferenc;1956;M4;HUN;MATASZ Székesfehérvár;Székesfehérvár;M;50;16 (F/3);5018;5738;6042;16798;5839;6005;9040;20884;4687;6216;4712;15615;6048;6546;6218;18812;72109;195.0;2008;True;52;6.163162393162393
30.0;Zlinszky András;1983;M1;HUN;Regnum Marianum SE;Tihany;M;48;2 (F/1);4278;5056;5953;15287;5286;6049;9290;20625;4782;6689;5326;16797;6171;7160;6472;19803;72512;195.0;2008;True;25;6.197606837606838
31.0;Mészáros Zoltán;1978;M2;HUN;Honvéd Aurora SE;Szigetszentmiklós;M;63;13 (F/2);5023;5739;6036;16798;5842;6009;9040;20891;4692;6197;4847;15736;6053;6773;6303;19129;72554;195.0;2008;True;30;6.201196581196581
32.0;Salamon István;1962;M3;HUN;-;Mezőtárkány;M;34;17 (F/3);4798;5555;6614;16967;5838;6317;9640;21795;4711;6116;4811;15638;6136;7228;5677;19041;73441;195.0;2008;True;46;6.277008547008547
2.0;Lehner Csabáné;1963;F3;HUN;-;Szombathely;F;52;2 (N/3);5216;5852;6129;17197;5776;5956;8593;20325;4822;6549;5254;16625;6263;7334;6772;20369;74516;195.0;2008;True;45;6.368888888888889
33.0;Ács László;1960;M3;HUN;Szolnoki HSE;Szolnok;M;62;18 (F/3);4880;5543;5467;15890;5482;5676;9542;20700;4726;6362;5458;16546;6087;7227;8088;21402;74538;195.0;2008;True;48;6.3707692307692305
3.0;Berzy Judith;1973;F2;HUN;-;Budapest;F;22;1 (N/2);4662;0;12448;17110;5646;6097;9150;20893;4755;6403;5369;16527;6298;7188;6998;20484;75014;195.0;2008;True;35;6.411452991452991
34.0;Dáva Iván;1960;M3;HUN;-;Budaörs;M;23;19 (F/3);4373;5354;6712;16439;5230;0;14547;19777;4625;6914;5831;17370;6220;7816;7460;21496;75082;195.0;2008;True;48;6.4172649572649565
35.0;Schwarz Márk János;1975;M2;HUN;-;Balatonfüred;M;35;14 (F/2);5571;6558;6825;18954;6141;6422;8606;21169;5159;6555;4453;16167;6234;6695;5941;18870;75160;195.0;2008;True;33;6.423931623931624
36.0;Polacsek Kálmán;1960;M3;HUN;TTT-HSE;Tatabánya;M;69;20 (F/3);4976;5892;6018;16886;5937;6345;8589;20871;4931;7246;5521;17698;6458;7566;6400;20424;75879;195.0;2008;True;48;6.485384615384616
37.0;Szabó Béla;1963;M3;HUN;-;Keszthely;M;40;21 (F/3);5281;6063;6393;17737;5628;5996;9141;20765;4767;6255;5010;16032;6275;7519;7643;21437;75971;195.0;2008;True;45;6.493247863247864
38.0;Nyeste Gyula;1969;M2;HUN;-;Gyöngyös;M;31;15 (F/2);4800;5591;6575;16966;5837;6318;10515;22670;4691;6117;5362;16170;6134;7233;7643;21010;76816;195.0;2008;True;39;6.565470085470086
39.0;Fenyő István;1963;M3;HUN;-;Mucsi;M;24;22 (F/3);5030;6031;7523;18584;5692;7298;10885;23875;4388;6251;5034;15673;6091;6883;6183;19157;77289;195.0;2008;True;45;6.605897435897436
40.0;Kreszta Zoltán;1970;M2;HUN;-;Budapest;M;11;16 (F/2);4049;5021;6544;15614;5264;5641;9249;20154;5200;6769;6629;18598;6472;8772;7865;23109;77475;195.0;2008;True;38;6.621794871794871
41.0;Séra István;1960;M3;HUN;-;Budapest;M;36;23 (F/3);5264;6246;6717;18227;6139;6977;9161;22277;5059;6509;4944;16512;6166;7290;7256;20712;77728;195.0;2008;True;48;6.643418803418804
42.0;Keresztes János;1966;M3;HUN;-;Budapest;M;28;24 (F/3);4737;5641;6590;16968;5833;6527;9510;21870;4960;7375;5362;17697;6565;7804;7527;21896;78431;195.0;2008;True;42;6.703504273504274
43.0;Durst János dr.;1961;M3;HUN;-;Szolnok;M;12;25 (F/3);5494;6639;7889;20022;6195;7030;10334;23559;5245;7091;5772;18108;6558;0;14026;20584;82273;195.0;2008;True;47;7.031880341880342
44.0;Szabó Tibor;1965;M3;HUN;Proathlon VK;Budapest;M;59;26 (F/3);5592;6561;7869;20022;6295;6927;10335;23557;5254;7091;5767;18112;6562;7496;7567;21625;83316;195.0;2008;True;43;7.121025641025641
4.0;Tóth Jutka;1973;F2;HUN;-;Lovászpatona;F;43;2 (N/2);5380;0;13124;18504;6304;6940;10645;23889;5146;7234;6035;18415;6521;7881;8759;23161;83969;195.0;2008;True;35;7.176837606837607
45.0;Vass János;1967;M3;HUN;-;Budapest;M;44;27 (F/3);5047;0;13064;18111;6034;7185;10551;23770;5135;7550;6290;18975;6598;8159;8386;23143;83999;195.0;2008;True;41;7.179401709401709
46.0;Kollár Zoltán;1965;M3;HUN;-;Budapest;M;55;28 (F/3);5728;6961;7675;20364;6606;7043;9984;23633;5516;7101;5816;18433;6757;7741;7903;22401;84831;195.0;2008;True;43;7.25051282051282
5.0;Országné Faragó Éva;1966;F3;HUN;Szondi SE;Kecskemét;F;32;3 (N/3);4752;5533;6163;16448;5806;6508;10214;22528;5342;8935;7092;21369;6989;9227;8630;24846;85191;195.0;2008;True;42;7.281282051282051
47.0;Molnár Attila;1963;M3;HUN;-;Oroszlány;M;45;29 (F/3);5205;6199;8044;19448;6208;6674;10126;23008;5326;7692;6644;19662;6684;8679;8060;23423;85541;195.0;2008;True;45;7.311196581196581
6.0;Hack Zsanett;1984;F1;HUN;-;Nyergesújfalu;F;27;1 (N/1);4820;6515;7109;18444;6071;8014;10175;24260;5034;8478;6787;20299;6616;8691;9245;24552;87555;195.0;2008;True;24;7.483333333333333
48.0;Maczó András;1949;M4;HUN;Futapest;Budapest;M;26;30 (F/3);5684;6992;7658;20334;6606;7062;10404;24072;5514;0;13767;19281;7059;9242;8528;24829;88516;195.0;2008;True;59;7.565470085470086
